1111111111
1111000001
1111011101
1111053101
1000220101
1013001101
1011111001
1000000011
1111111111
