111111
100011
120451
133201
111111
