11111111
13000001
13012001
13425201
13002011
11111111
