11111111
13310001
10002201
13021501
10300201
11111111
