11111111
11100111
10230201
13342201
10530001
11111111
