11111111
11323151
13100201
12020201
10303011
11111111
