1111111
1020301
1310001
1022001
1543001
1111111
