1111111
1003011
1301011
1002251
1030201
1111111
