11111111
11533001
10220001
10032111
10400111
11111111
