11111111
10323201
16200001
13112001
13200001
11111111
