11111111
13310001
10320201
15402001
11110001
11111111
