11111111
11020031
10202331
10520131
10010001
11111111
