11111111
10300111
13022001
10000451
11111111
