11111111
11001001
10025201
10344201
10303001
11111111
