11111111
13400001
13022001
13210001
11523001
11111111
