11111111
10330111
13402111
10202051
10002301
11111111
