11111111
10001501
13100201
10023401
10000111
11111111
