11111111
13005111
13310001
13222201
13200001
11111111
