11111111
10400001
15322001
13310201
10000111
11111111
