11111111
11000001
13212051
13020211
13300011
11111111
