11111111
13003111
15212001
12303201
10000231
11111111
