111111111
111110011
111110011
111110011
111111011
100000011
100010311
111110111
111110151
111110101
111112101
111110001
111111111
