1111111111111
1111100000001
1111101111101
1100030000101
1101111100101
1120030020101
1101111101101
1020030021501
1001111101011
1000030001011
1111101111011
1111100000011
1111111111111
