11111111111
15000000001
10322222301
10213131201
10233333201
10213131201
10233333201
10213131201
10322222301
10000000001
11111111111
