11111111111111
11111100000511
10000001211011
10121101302011
10103202031011
10230101101011
10110133000001
10000033101101
11010110103201
11013020230101
11020310112101
11011210000001
11000000111111
11111111111111
