1111111111111111111
1500000331100000001
1022220333302222001
1000000113300000001
1111111111111111111
