1111111111111111111111111111
1111111111110040100000011111
1300500200000040111111110001
1111111111110040000000000001
1111111111110040111111110001
1111111111111111100000011111
