111111111
150000001
100020001
102222201
100020001
102222201
100020001
111101111
111101111
111101111
111101111
110333011
110333011
110333011
110330011
110330011
111111111
