1111111111111
1111110111111
1111100011111
1111000000111
1110242420111
1100433340011
1000235320001
1100433340011
1110242420111
1111000001111
1111100011111
1111110111111
1111111111111
