111111
100301
102031
112201
135011
111111
