1111111111
1500000001
1022222211
1020000001
1020221031
1020200331
1020100331
1020033331
1010333331
1111111111
