111111111
130020031
103020301
100623001
122242221
100323001
103020301
130020031
111111111
