11111001111
10001111001
10200000201
11011111001
11010031011
11013350001
11010031101
10011111101
10200000201
10011110001
11110011111
