11111111111
11110501111
11110001111
11112021111
10020002001
13333433331
10020002001
11112021111
11110001111
11110001111
11111111111
