11111111111
11000300011
10020302001
10212321201
10020302001
13333533331
10020302001
10212321201
10020302001
11000300011
11111111111
