1111111111111111111111111
1111111111111111100111111
1111111111111111120111111
1111111111111111100111111
1111111111111111101111111
1111020202020202000000101
1110010101010101022250111
1111033333333333000000101
1111111111111111101111111
1111111111111111100111111
1111111111111111120111111
1111111111111111100111111
1111111111111111111111111
