11111111111
10000010001
10141412001
10433340201
10131312001
10433340201
11141412001
10202020501
10000000001
11111111111
