1111111111111111
1501000331000001
1001002331002001
1001001331001001
1021221221221201
1001001331001001
1002001332001001
1000001330001001
1111111111111111
