1111111111111111111
1111111100011111111
1111100100010011111
1111102002002011111
1000000100010010001
1010102111112010101
1000000336330010001
1111111111111111111
