111111
130011
153201
102001
111001
111111
