111111111
130050031
132222231
130000031
132242231
130000031
132222231
130000031
111111111
