11111111111111111111111
11111111111111110000011
11111111000000012020001
10033301111110010202001
10011100333011012020201
10033300111001110202001
15011100333000002020201
10033300111001110202001
10011100333011012020201
10033301111110010202001
11111111000000012020011
11111111111111110000111
11111111111111111111111
