1111111
1100111
1102001
1002001
1634331
1002001
1102001
1100111
1111111
