1111111
1002331
1000251
1002311
1111111
