11111111111
11110501111
11110001111
11112021111
10023332001
10003430001
10023332001
11112021111
11110001111
11110001111
11111111111
