111111111
133313331
133313331
122212221
100010001
100010001
122212221
100010001
110010011
100010001
100000001
100151001
111111111
