111111111
100000001
102323201
103232301
102353201
103232301
102323201
100000001
111111111
