111111111111111
100000334000001
100222343222001
100000433000051
111111111111111
