1111111111111111111
1111111100011111111
1111111004001111111
1111110040400111111
1000100404040010001
1020004045404000301
1000100404040010001
1111110040400111111
1111111004001111111
1111111100011111111
1111111111111111111
