11111
10501
13231
12321
13231
10201
10001
10001
11111
