111111111111111111111
111111111110001111111
111111110000200111111
111000010202222111111
111100010222000011111
100010010520022011111
111010010222200011111
111111110200002011111
111113313111120111111
111113333333333100001
111113333330001111111
111111111111111111111
