11111111111
11111000231
11111011111
10000400001
10004040001
10040404001
10404040401
14040404041
10404040401
10040404001
10004040001
10000400001
11111011111
15000011111
11111111111
