111111111111
100000000001
103333333201
103222223201
103233323201
103232323201
103232623201
103232223201
103233333201
103222222201
100000000001
111111111111
