1111111111
1303030301
1232323231
1323232321
1232323231
1020202021
1000050001
1111111111
