111111111111
130303530301
123232323231
132323232321
123232323231
132323232321
120202020201
100000000001
111111111111
