1111111111111
1111105011111
1111001001111
1110020200111
1100101010011
1334020204331
1010101010101
1334020204331
1100101010011
1110020200111
1111001001111
1111100011111
1111111111111
