1111111111111111
1111111110111111
1111111100011111
1111111000001111
1111110200050111
1111102020000011
1111020002000001
1110302020200011
1103030200020111
1030003020201111
1103030302011111
1110300030111111
1111030301111111
1111103011111111
1111110111111111
1111111111111111
