111111111111111111111
100000100000001000001
111111101111101111111
100000030000030000001
101111101111101111101
101000101000101000101
101020101020101020101
101000101000101000101
101101101101101101101
100101000101000101001
130101020101020101031
100101000101000101001
102101111101111101201
103030000030000030301
102101111101111101201
100100000050000001001
111111111111111111111
