100000000000001
111001111100111
111111000111111
111111404111111
111100232001111
111100303001111
111110232011111
111111050111111
111111111111111
111111111111111
111111111111111
111111111111111
