111111
130011
150211
104201
130001
111111
