11111111111
10000000001
10000000001
10333333301
10333333301
11111211111
10002020001
10020202001
10002020001
10020202001
10002020001
11111011111
10000200001
10000000001
10000500001
10000000001
11111111111
