11111111111
11111111111
10000000001
10232023201
10323232301
10232023201
11002320011
11023632011
11102320111
11102020111
11333433311
11222222211
11333333311
11100000111
11111111111
