1111111111111
1111100011111
1111103011111
1110022200111
1110333330111
1002322232001
1032325232301
1002322232001
1110333330111
1110022200111
1111103011111
1111100011111
1111111111111
