1111111111
1100500011
1120202011
1101311111
1103330011
1001310001
1002020001
1111111001
1111111111
