11111111111
11100000011
11100000011
11112110111
11000100001
11000100001
11121111211
10000100001
10000100001
11211112111
11000333331
11000500001
11111111111
