111111111
110001111
110320001
110102101
132320101
101202101
132303101
100011101
111310001
111000501
111111111
