111111111
114343411
113434311
114343411
113434311
114343411
110232011
110020011
111151111
100000001
102020201
110202011
112020211
110202011
110000011
111111111
