111111
113531
102211
103201
100001
111111
