1111111111111
1434310000001
1363312222201
1434330000001
1333332020201
1331111111111
1202011111111
1002011111111
1202011111111
1002011111111
1202011111111
1000011111111
1111111111111
