11111111111111111
11111111110231111
11111111040240111
11111100400230011
11113304040232011
11113540400232011
11113304040232011
11111100400230011
11111111040240111
11111111110231111
11111111111111111
