11111111111
10000500001
10202020201
11000000011
11102020111
11113331111
11111311111
11111311111
11111311111
11111311111
11111311111
11111311111
11113331111
11102020111
11000000011
10202020201
10000000001
11111111111
