11111000011111
10001111110001
10200000000001
10020202020201
11011111111101
10434343330101
10333334340151
11111111101101
10202020200101
10000000020101
10001111100001
11111000111111
