1111111111111111111111111
1523231000001320001023001
1023231222321032301023201
1023230333330023200033331
1023231002201002321023221
1000231000001000031000001
1110111110111110111110111
1023231023001300031002031
1023231323201022301022301
1023230023230023220023221
1023231323201032001032301
1000001023001302031300001
1111111111111111111111111
