11111111111111111111111
11111111111111111111001
10000000000200000000031
15222222222233333333331
10000000000011111111111
11111111111111111111111
