1111111111100011111
1111111000111110011
1111111030303030001
1111111101100000001
1111000100111101111
1111030030100000011
1111101100100000011
1000100111100000011
1030030100111111011
1101100100202000011
1101111120202010111
1130310020202000011
1103002020202021011
1130310000100000511
1111111111111111111
