111100000000001111
111010000000010111
110231000000132011
103223100001322301
110322310013223011
111032231132230111
111103220022301111
111110320023011111
111111005000111111
111111000000111111
111111122221111111
111111100001111111
111111102201111111
111111133331111111
111111133331111111
111111111111111111
