111111111111111
150000100000001
102320102323201
103130003101301
102320102020201
100000103101301
111011102323201
102220100000001
100000111111111
100002002333331
102222002343431
100002002333331
111111111111111
