11111111111111111
10001011011111111
10001111110111111
11000000011111111
11222020233433431
11052222233433431
11222020233433431
11000000011111111
11110011110111111
11110010011111111
11111111111111111
