111111111
100050001
102222201
102000201
102000201
111101111
102020201
133333331
103333301
100000001
111010111
104444401
100000001
100000001
111110011
111111111
