1111111111111111111111111
1000001444441000041000001
1033301400041040401000001
1033300400040004000444441
1033001400041040401000001
1000001444441400001000001
1110111111111111111110111
1004001040001400001002001
1040001040401040401020201
1400040000400044000200201
1040401040401040401022201
1004001000401000041000051
1111111111111111111111111
