11111111111
11013131311
15202020231
11010141311
11040402011
11010101011
11000000011
11111111111
