1111100011111
1111110111111
1133311133311
1033301033301
1022222222201
1100000000011
1110222220111
1111000001111
1111130311111
1111115111111
1111111111111
1111111111111
