11111111111111
11110000100011
11100500002011
11022222112111
11020000310111
11001113310111
11011033310011
11000333310201
11111331110201
10000001022001
10000000000011
11111111111111
