1111111
1000001
1000001
1222221
1333331
1333331
1222221
1005001
1111111
