11111111
15000001
13332221
10100101
12223331
10100101
10100101
10111101
10000001
11111111
