11111111111111
15000000000001
10333332222201
10320232303201
10302032030201
10320232303201
10333332222201
10222223333301
10230323202301
10203023020301
10230323202301
10222223333301
10000000000001
11111111111111
