1111111111111111111111111111111111
1004302302304302301000233320020001
1502002002032002000002033302002001
1002304302302304301020033300200201
1111111111111111111111111111111111
