1111111111111
1000000000001
1012111133301
1013200235301
1013020033301
1012002002101
1013200200101
1013020020101
1012002002101
1030233233201
1023111111101
1000000000001
1111111111111
