111111111
111000101
111000301
111014001
111040101
111400101
104001101
102100001
105111111
111111111
