11111111111111111111
10040301003200430041
12000104000004000201
10302000241302301001
10031040103001020031
10204034040010120101
14040200100403003041
10401020345020124101
13003002001000304031
10204020103020002001
11000132034001024011
10010000100230003031
10202034021000201001
14040001000030040041
11111111111111111111
