1111111111111111111
1111100013111111111
1523101112002311111
1101111310110111111
1120231202312023111
1131011011113101111
1111200231311120231
1111311111223131011
1111110000001111011
1113020211131320211
1111211013111101311
1111313202132021111
1111111110110131111
1111111132002111111
1111111111113111111
1111111111111111111
