11111111111
10000000001
10020202001
10252020201
10020111111
10202111111
10020111111
10202111111
10020000031
10121111101
10133333201
10131113101
10131413101
10131113101
10233333101
10111112101
13000000001
11111111111
