11111111
13320331
13200231
12011201
10211021
13200231
13302331
11111331
15202221
10000001
11111111
