111111111111111111111
111000111111111111111
100020001111111111111
102222201111111111111
100020001111111111111
111021011000001111111
111001010000001303001
111021010000001303001
111001010000001303001
111211011111111303001
111010000000000303001
111010000111111311511
111011110100001300001
111020200100001111111
111000001111111111111
111111111111111111111
