1111111111111111
1000000000011111
1444444440011111
1300000040011111
1444444040011111
1000004040011111
1111104040000001
1111104044444441
1111104000000251
1111104004444441
1111104444000001
1111100000000001
1111111111111111
