111111111111111
100000010000001
102222203333301
102030213020301
152333203222301
102030213020301
102222203333301
100000010000001
111111111111111
