111111111111
150000000001
102222333301
102333222301
102322332301
102320032301
103230023201
103233223201
103222333201
103333222201
100000000001
111111111111
