1111111111111111111
1111111005001111111
1111111010101111111
1111111000001111111
1111111011101111111
1111111000001111111
1111111113111111111
1111111113111111111
1111111113111111111
1330000200020000331
1111111020201111111
1111111202021111111
1111111020201111111
1111111200021111111
1111111011101111111
1111111010101111111
1111111010101111111
1111111010101111111
1111111310131111111
1111111310131111111
1111111110111111111
