1111111111111
1000001000001
1023201023201
1031304031301
1023201023201
1000001500001
1114111114111
1000001000001
1023201023201
1031304031301
1023201023201
1000001000001
1111111111111
