1111111111111
1000004000001
1020040400301
1000404040001
1004040404001
1040404040401
1404045404041
1040404040401
1004040404001
1000404040001
1030040400201
1000004000001
1111111111111
