11111111111111
10000000000001
10111111111101
10100000000101
10101111110101
10101000010101
10101011010101
10101231010101
10100001010101
10111101010101
10000001010101
11111111010101
10000000010101
15111111110101
10000000000101
14111111111101
10000000000001
11111111111111
