111111000111111
100001111100001
102320050032301
103031111120201
102320000032301
100001111100001
111111000111111
