1111111111
1110001111
1110100111
1110232111
1111323001
1002332101
1002233301
1002320111
1001010111
1111050111
1111111111
