111110101000011111
110011111111110011
100000000000000001
100100111111111001
110111114444441011
110100011111111001
110100002353200001
110100011111110011
100111111000111111
100000000002114441
110011111010014441
111110001200011111
100130300001110001
110111111111000111
