111111111111111111111
111111000111111111111
110000000000000000001
110111000111111111101
110101101100000000101
110100101000111110101
110100121111100010101
111110130320005010101
100011100011100010101
100000230310111110101
100011112110010100101
111110010111110111101
111111110000000000001
111111111111111111111
