1111111
1110001
1520031
1322001
1301001
1111111
