1111111
1130311
1020111
1052001
1032001
1111111
