11111111
10301111
10202001
13032051
11111111
