1111111
1110001
1000001
1042211
1334511
1111111
