1111111
1111001
1520001
1044001
1340001
1111111
