1111111
1000231
1000231
1001231
1001501
1111111
