1111111
1111001
1100001
1522001
1340301
1111111
