111111
100311
100251
112001
110301
111111
