1111111
1030111
1305111
1022001
1020301
1111111
