111111
100011
100051
112201
130311
111111
