11111111
11111001
10400001
13442001
15400001
11111111
