1111111
1310011
1320001
1020201
1513001
1111111
