1111111
1030111
1030111
1522201
1030001
1111111
