1111111
1030001
1522201
1110301
1110301
1111111
