1111111
1540301
1112001
1020401
1030001
1111111
