1111111
1040001
1510331
1022001
1020301
1111111
