1111111
1030201
1010451
1000241
1000301
1111111
