11111111
11130001
11110401
10000241
10000451
11111111
