1111111
1003251
1302201
1031011
1000011
1111111
