11111111
11300111
13320111
10222001
13000451
11111111
