1111111111110111111
1000100001011103331
1000221000500003331
1000101110001000001
1101101110010000001
1102020000010101111
1100202110010000001
1111010011110101101
1001010000110100001
1000000010110100011
1010000000010100011
1000011011010111111
1000000000000111111
1101101110000111111
1100001010000111111
1111111011111111111
