111111111
100000001
104444401
104000401
104203401
105404001
104302401
104000401
104444401
100000001
111111111
