11111111111111
11111100111111
13000200200031
11444400444411
11000444400011
11000000000011
11444444444411
11500000000011
11111111111111
