111111111111111
111111000111111
130002010200031
114444000444411
110004444400011
110000000000011
114444444444411
115000000000011
111111111111111
