1111111
1000001
1344431
1010201
1000201
1101011
1020001
1020101
1344431
1005001
1111111
