1111111
1004001
1044401
1004001
1604031
1004001
1113111
1023201
1023201
1023201
1000001
1111111
