11111111111
11100400111
11104440111
11000400011
10040404001
15434443401
10040404001
11000400011
11100400111
11111311111
11102320111
11102320111
11102320111
11100000111
11111111111
