11111111111
11110301111
11110401111
11110401111
10000200001
13442424431
10000200001
11110405111
11110401111
11110301111
11111111111
