1111111111111
1000004000001
1042424242401
1034340434301
1101004001011
1150001000011
1101004001011
1034340434301
1042424242401
1000004000001
1111111111111
