111111111
100040001
104242401
103404301
110040011
110040011
115414011
110040011
110040011
103404301
104242401
100040001
111111111
