1111111111
1300100311
1020102011
1254240211
1020100311
1303110111
1101134001
1300100201
1204032031
1020111111
1300111111
1111111111
