11111111111
10001110011
15222333011
11101110001
11100000001
11111111111
