1111111111
1601000001
1020000001
1010140101
1010100101
1014444101
1000100001
1111111111
