11111111111
16011000001
10200000001
10104140101
10100100101
10144444101
10000100001
11111111111
