11111111111
13004640031
10002020001
10101410101
10100400101
10111211101
10000400001
11111111111
