111111111
100000001
101111101
130000101
131222001
131500201
130011111
111111111
