1111111111111
1110000000111
1310112110131
1204004004021
1010101010101
1002346432001
1010101010101
1204004004021
1310110110131
1110000000111
1111111111111
