11111111111111111
10010011111111111
10212011111111111
10010011111111111
11010110000000001
13010312111210101
13210310200010201
13343320333303101
10010012121210101
11010110000000001
10010011111111111
10212011111111111
10510011111111111
11111111111111111
