111111111
100000001
100111101
133000101
131222201
131500201
130011001
111111111
