111111111111
110000001111
102444100111
104000110011
104004001001
104040001101
101100040401
100100400401
110011000401
111001444601
111100000011
111111111111
