1111111111111
1113001003111
1111002001111
1311412141131
1004020004001
1001013121001
1122035302211
1001213101001
1004000204001
1311412141131
1111002001111
1113001003111
1111111111111
