1111111111111
1000000000001
1044444444401
1040000040401
1040000010401
1041111110201
1060000000111
1111111111111
