1111111111111
1300302030031
1020131310201
1310242020131
1020131310201
1010201020101
1324105014231
1010201020101
1020131310201
1310202420131
1020131310201
1300302030031
1111111111111
