111111
100001
132101
104001
132101
154041
132101
104001
132101
100001
101011
100011
111111
