11111111
10000001
10011101
13000101
13122201
13150201
13000111
11111111
