111111111111111
111111000111111
100000010000001
163344444422201
100000010000001
111111000111111
111111111111111
