11111111111111111
10001111111111111
13444000001111111
10004012101111111
10001004001000001
11111012104000001
11111000004444461
11111111111000001
11111111111111111
