111111111111111
110000000000031
112444444421131
100010001000131
100010001000401
112404111121151
100010001000401
100010001000131
112444444421131
110000000000031
111111111111111
