111111111111111
110000000000031
114244444421131
100010001000131
100010001000401
111204111121151
100010001000401
100010001000131
114244444421131
110000000000031
111111111111111
