11111111
10000001
10111101
10000101
13122201
13150001
13001111
11111111
