111111111
110302011
104343401
103202301
104020401
103212301
104020401
103252301
104020401
103212301
104020401
103202301
104343401
110203011
111111111
