1111111111111111111
1111100111111000111
1000111100000000111
1000001101101100111
1000000000000000011
1110000110110000011
1110111110111110001
1112111110511000001
1102001112111020011
1102001000111001111
1102002010002201111
1100000100011001111
1111111100001111111
1111100000000011111
1111133333333311111
1111111111111111111
