1111111111111
1111001001111
1001022201001
1000001000001
1004001004001
1414111114141
1004001004001
1010001000101
1000036300001
1111111111111
