1111111111111
1110330000011
1000131010001
1002242220001
1110360001111
1111111111111
