11111111111
11000100011
11200100211
10040104001
10004040001
11110101111
10004040001
10040404001
11600100311
11100100111
11111111111
