1111111111111
1001001001001
1000022200001
1004002004001
1414111114141
1004001004001
1010036300101
1033412143301
1010034300101
1004001004001
1414111114141
1004002004001
1000022200001
1001001001001
1111111111111
