111111111111111
100000010000001
104444010444401
104002010600401
104010010010401
104001111100401
100401000104001
101401000104101
100401000104001
104001111100401
104010000010401
104000444000401
104444010444401
100000000000001
111111111111111
