11111011111
11001110011
10400000201
10040104001
11004040011
11010401011
11004040011
10040104001
10600000401
11001110011
11111011111
