1111111111111111111
1000000001000000051
1024441101011444201
1110000401040000111
1110000401040000111
1111111340431111111
1111111301031111111
1110000401040000111
1110000401040000111
1024441101011444201
1000000001000000001
1111111111111111111
