1111111111111111111
1000000001000000001
1024441101011444201
1110000401040000111
1100000401040000011
1101111634331111011
1100000401040000011
1110000401040000111
1024441101011444201
1000000001000000001
1111111111111111111
