1111111111111
1000005000001
1020201020201
1122221222211
1100101010011
1113433343111
1133332333311
1110011100111
1111110111111
