1111111111111
1000000000001
1020201020201
1122203022211
1100121210011
1113433343111
1133340433311
1110010100111
1111110111111
1110010100111
1133332333311
1113433343111
1100104010011
1122201022211
1020221220201
1000005000001
1111111111111
