1111111111111
1000000000001
1020201020201
1122203022211
1100121210011
1113333333111
1134444444311
1133332333311
1113332333111
1100134310011
1122201022211
1020221220201
1000005000001
1111111111111
