1111111111111
1004000000301
1304044040001
1001020011441
1041144410001
1000400042401
1040401040401
1042400040001
1000144411401
1441100201001
1000404404031
1060000004001
1111111111111
