1111111111111111111
1111001000000000011
1001000020202020211
1333301111112020201
1333310000510202001
1133310000012020201
1133310000010202001
1133310000012020201
1133310000010202001
1133310000012020201
1133310000102020201
1133310000102020201
1133310000102020201
1133310000102020201
1133300000102020201
1100010000100000011
1111111111111111111
