1111001111111111111
1001111000000000011
1333300020202020211
1333301111120202001
1133310005102020201
1133310000120202001
1133310000102020201
1133310000120202001
1133310000102020201
1133310000120202001
1133310001020202011
1133310001020202011
1133310001020202011
1133310001020202011
1133300001020202011
1100010001000000111
1111111111111111111
