1111111111111111111
1001001000000000001
1333300020220202201
1333341111002020201
1333300005120202001
1000100000100000011
1111111111111111111
