1111111111111
1100010010011
1102302012011
1111101013011
1000001010111
1021100000111
1100031110111
1031011300111
1021000312011
1001011000011
1111011011111
1111020053201
1111001310001
1111111111111
