111111111111
111111103011
100000104011
134440004011
100020124011
111511100011
110001110111
110421020001
110400044431
110401000001
110301111111
111111111111
