111111111111111
111111001111111
102000000111111
101212210011111
101010000011111
102011111011111
102020201001111
102013333301111
102011111101111
102000000101111
105133333330201
111111111000001
111111111111111
