1111111111111
1110001000111
1113401043111
1110405040111
1111414141111
1000400040001
1000400040001
1102444442011
1100000000011
1111111111111
