1111111111111
1100001000011
1134401044311
1100405040011
1111414141111
1000400040001
1000400040001
1102444442011
1100000000011
1111101011111
1111100011111
1111111111111
