11111110001111111
11100011111000111
10201020102010201
10400040104000401
13440443534404431
10000040004000001
11111111111111111
