1111111111111111111
1110000401040000111
1110020405040200111
1103110001000113011
1034301011101034301
1020204010104020201
1004301411141034001
1020201001001020201
1034310001000134301
1102100201020012011
1110030011100300111
1111111110111111111
