1111111111111
1110011111111
1110002001111
1002411101111
1003032300111
1114045404111
1110032303001
1111011142001
1111002000111
1111111100111
1111111111111
