11111111111111111
10010011000000011
13333332020202001
13313310202020201
13111112020202051
13010000111111111
11000111111111111
11111111111111111
