11111111111111111
11110000000001111
11000111111100011
11010400000401011
15024443134442001
10010400000401001
10010111111101001
11000100000100011
11111100000111111
