1111100011111
1000111110001
1010204020101
1000404040001
1101130311011
1100400040011
1111115111111
1100400040011
1101130311011
1000404040001
1010204020101
1000111110001
1111100011111
