1111100011111
1000111110001
1010204020101
1000404040001
1101130311111
1100400011111
1111115111111
1111110040011
1111130311011
1000404040001
1010204020101
1000111110001
1111100011111
