111110000011111
100011111110001
101020040020101
100040411040001
111103000301111
111111010111111
111103050301111
100040114040001
101020040020101
100011111110001
111110000011111
