1111111110111111111
1111110010100111111
1111102011102011111
1000101001001010001
1000033205023300001
1111111141411111111
1000033200023300001
1000101000001010001
1111102011102011111
1111110010100111111
1111111110111111111
