111111111111111
100000000000051
104444444444401
104000000000401
104122213331401
104000000000401
104444444444401
110000000000001
111111111111111
