1111111111111
1110001000111
1134001004311
1101101011011
1101041401011
1101001001011
1101001001011
1101401041011
1100441440011
1004006004001
1011012101101
1002010102001
1100004000011
1111111111111
