11111111111
10001643311
10221201111
10201320001
10201301001
10001311211
10000300011
11101320111
11100000111
11111111111
