1111111111
1111331111
1111023311
1111001111
1001320001
1021301001
1001311211
1020325201
1001322101
1000000001
1111111111
