11111111111111111
11110030503001111
11133330403333111
11114141114141111
10202000100020201
10202200100220201
10000000100000001
11111111111111111
