1111111111111111111
1100000001000000011
1102022001002202011
1102020001000202011
1111141411141411111
1004333304033334001
1001100302030011001
1040111110111110401
1400000035300000041
1040111110111110401
1001100302030011001
1004333304033334001
1111141411141411111
1102020001000202011
1102022001002202011
1100000001000000011
1111111111111111111
