1111111111111
1000004000001
1022224222201
1000006000001
1111114111111
1111333031111
1111133031111
1111114111111
1111303311111
1111303331111
1111114111111
1020003000201
1022203222201
1000000000001
1111111111111
