111111111111111
111000030000111
104000111000401
101414040414101
101010121010101
100000050000001
101010121010101
101414040414101
104000111000401
111000030000111
111111111111111
