11111111111111
11100111111111
11100000201111
10023111101111
10030300301111
11110100320111
11110100104001
11112111132001
11115200000111
11111111100111
11111111111111
