1111111111111
1000000000051
1044444444401
1040000000401
1041133311401
1040000000401
1042221222401
1040000000401
1041133311401
1040000000401
1044444444401
1100000000001
1111111111111
