1111111111111111111
1110000000000000111
1100101010101010011
1024242423242404201
1003030310130303001
1011111405041111101
1003030310130303001
1024042423242424201
1100101010101010011
1110000000000000111
1111111111111111111
