111111101111111
111000101000111
104002111200401
101013040310101
101010141010101
101002050200101
101113040311101
101110141011101
100000040000001
101110131011101
101114232411101
104000111000401
111000101000111
111111101111111
