11111111111
11111100111
11000433111
11033433011
11013411011
11013331011
11013331011
11011311011
10001310001
10222422201
10202020201
10020202001
11002020001
11111501111
11111111111
