1111111001111
1000001111001
1040404333331
1004011130331
1110411133331
1111001111111
1100202020111
1002020202011
1020202020201
1000000000051
1111111111111
