1111111111111
1111000000001
1323231323201
1132323232001
1113234320201
1111234321111
1002323232011
1023231323201
1000000000051
1111111111111
