111111111111111
111111000111111
111110040011111
111100444001111
111004404400111
110044000440011
100440213044001
104400000004401
100440312044001
110044000440011
111004404400111
111100444001111
111110040011111
111111050111111
111111111111111
