11111110001111111
10000011111000001
13444000400044431
10004400200440001
11100111211100111
11110000500001111
11111111111111111
