111111111111
100000000001
104444444401
100400004001
100401104001
110401104011
110201004011
110001004011
111111114011
111601004011
110401004011
110401104011
100401104001
100400004001
104444444401
100000000001
111111111111
