111111111111
100000500001
101212212101
103330033301
101212212101
103330033301
101212212101
100000000001
111111111111
