111111111
110010011
110010011
110010001
134444201
110000111
100010111
151114111
100010111
110000111
134444201
110010001
110010011
110010011
111111111
