111111111
110010011
110010011
110010001
134444201
110000111
100110001
101111101
100000051
111111111
