1111111111111111111
1100100400040010011
1100100100010010011
1100100010100010011
1344442010102444431
1100001100011000011
1001111000001111001
1011111222221111101
1033333005003333301
1011111222221111101
1001111000001111001
1100001100011000011
1344442010102444431
1100100010100010011
1100100100010010011
1100100400040010011
1111111111111111111
