1111111111111111111
1110000000000000001
1112121212121212101
1033333000403333401
1012121011101212101
1043333040003333301
1012121212121212101
1000000000000000001
1012121212121212101
1033333040003333401
1012121011101212101
1043333000403333301
1012121212121212101
1000000000000000051
1111111111111111111
