11111111111
11100000001
11131313101
10201400201
10100400101
10241114201
10100400101
10200410201
10131313111
15000000111
11111111111
