11111111111
11110000001
10524212101
10303030301
10120112111
10303030111
10121211111
10000011111
11111111111
