11111111111
10000000111
10444440111
10400045001
10401024401
10401000401
10403110401
10420000401
11344444401
11100000001
11111111111
