11111111111111111
13000000100000031
10011110101111001
10100024142000101
10102310101320101
10004040504040001
10102310101320101
10100024142000101
10011110101111001
13000000100000031
11111111111111111
