1111111111111111111
1000000001000000001
1011111101011111101
1010000241420000101
1032003101013002301
1013442405042443101
1032003101013002301
1010000241420000101
1011111101011111101
1000000001000000001
1121111131111111111
1004040400404040001
1000000010000000001
1111110011111111111
1111111111111111111
