1111111111
1100111111
1100111111
1340111111
1144001111
1154400001
1100440001
1110044011
1111004211
1111000011
1111111111
