11111111111
10400000001
10101214101
10404000401
10101400101
10400333401
10121214101
15000000001
11111111111
