111111111
110010011
102050201
101444101
103000301
110000011
111111111
