11111110001111111
11100011111000111
10300030103000301
10144410101444101
10200020102000201
11111004040011111
11111101010111111
11111100400111111
11111020502011111
11111014441011111
11111030003011111
11111110000111111
11111111111111111
