1111111111111
1643300020201
1310121010101
1310100020201
1310121020101
1320100000201
1343222110101
1333100000001
1111111111111
