111111111
110000011
103000301
101444101
102020201
111030111
111454111
111030111
102020201
101444101
103000301
110000011
111111111
