11111000011111111
11001111110000011
10205020102000201
10144410101141101
10300030104000301
11100000300011111
11111111111111111
