11111111111111111
10001000000100011
14461044444402001
10001000010100001
10411041004010411
10001000100010001
11401140111001401
10001000101100001
10411041100111111
10001000111111111
11401140011111111
10004000011111111
10444444011111111
10000000011111111
11111111111111111
