11111011111
15001110001
10140204101
10104040101
10100100101
10100100101
10040111001
11004010011
11100400111
11111311111
11111111111
