11111111111
10043006111
10001000201
10111214001
10133330011
10111110111
10202022111
10000000111
11111111111
