111111101111111
110000111000011
100440010044001
104001010100401
103102414201301
101104020401101
100010060010001
111000111000111
111111101111111
