11111111
10000111
10222201
13310101
16033031
13310101
10222201
10000111
11111111
