11111111
11150111
10200201
10334401
10400401
10443301
10200201
11100111
11111111
