111111111111
111115011111
102000000201
103344444401
104000000401
104011110401
104000000401
104444443301
102000000201
111110011111
111111111111
