1111111111
1111501111
1020000201
1033444401
1040000401
1004444001
1040000401
1044443301
1020000201
1111001111
1111111111
