111111111111111
100300030003001
101211121112101
100400040004001
110404040404051
100400040004001
101211121112101
100300030003001
111111111111111
