111111111111
100000001111
103444401001
104000401201
104010400061
104000401111
100444421111
100000001111
111111111111
