111111111
100343001
101222101
102000201
102101201
102000201
102010201
101323101
101303101
101323101
103444301
104363401
111111111
