111111111
110011111
106011111
100404001
104040401
100404001
111010201
111000011
111111111
