1111111111111111111
1000000003000000001
1022222022202222201
1020002013102000201
1020000133310000201
1020201303031020201
1022013001003102201
1000133333333310001
1021300130310031201
1323333331333333231
1021300130310031201
1000133333333310001
1022013001003102201
1020201303031020201
1020000133310000201
1020002013102000201
1022222022202222201
1000000006000000001
1111111111111111111
