111111111111111111111111
111111111111111110001001
161000000000000000100401
131020202020202020101001
131020202020202020201201
131020202020202020001001
131111111111111111211201
133333333333333333333001
100111111111111111111001
111100000000000000001111
