1111111111111
1060100010001
1040004000401
1044444444401
1040004000401
1040100010401
1040111110401
1040100010401
1040004000401
1044444444401
1040004000201
1000100010001
1111111111111
