111111111
106010001
104000401
104444401
104000401
104010401
104010401
104010401
104000401
104444401
104000201
100010001
111111111
