111111111
106010001
104000401
104444401
101000101
101000101
104444401
104000201
100010001
111111111
