111111111
100010001
102050401
104444401
100040001
104444401
104000401
100010401
111111011
100010301
104000301
104444401
100040001
104444401
102000401
100010001
111111111
