1111111111111
1111111001111
1110000021111
1102001101111
1520001020011
1111011000211
1130001202011
1130001000211
1133000000011
1133331000001
1111111000001
1111111000111
1111111001111
1111111001111
1111111111111
