11111111111
10000300201
10020420251
11111311111
10302320301
10320302301
11111111111
