111111111
100000001
102002201
100200201
111131111
106042301
103240301
104030301
111111111
