11111111
10000001
10433401
10420411
11320201
10444001
10000051
11111111
