1111111111111
1000001520301
1043321220301
1042003044401
1030201000001
1111111111111
