1111111111111
1000001000401
1022003344601
1043444202201
1030001000001
1111111111111
