1111111111111
1030251000301
1024222023001
1000334332001
1004001023001
1111111111111
