11111111111
10000000001
10244344201
10401310401
10400500401
10401310401
10244344201
10000000001
11111111111
