1111111111111
1031000000401
1003220024001
1002334462201
1003201003001
1111111111111
