11111111111
13000100031
10402220301
12230324001
10300152301
11111111111
