11111111111
13000100061
10322420401
10230004201
10300100401
11111111111
