11111111111
13000100031
10032223201
10042303221
10325100301
11111111111
