1111111111
1111110001
1110032511
1100420111
1003201111
1030001111
1003201111
1102320111
1110030011
1111110001
1111111111
