1111111111111
1000301030001
1040421240401
1050300030401
1044421244401
1000001000001
1111111111111
