1111111111111
1032003002301
1012110112101
1032306032301
1012100012101
1000001000001
1111111111111
