1111111111111
1032003002301
1012100112101
1032306032301
1012110012101
1000000000001
1111111111111
