11111111111
10000300001
10121012101
13320502331
10121012101
10000300001
11111111111
