11111111111
10000300001
10101410101
14322522331
10101010121
10000300001
11111111111
