11111111111
10000000001
12101210101
13640204331
10101210101
10200300001
11111111111
