11111111111
10000000001
10121210101
14462004331
10121310101
10000000001
11111111111
