1111111111111
1000001000111
1043421010111
1030302045001
1040421210101
1000301000001
1111111111111
