1111111111111
1000001000301
1013121212101
1030305000301
1012121213101
1000001000001
1111111111111
