11111111
15000001
10444401
10400411
11404301
10024001
10000001
11111111
