111111111
100000001
104444401
104000401
104120401
100000111
116111111
111111111
