111111111
100000001
104444401
104000101
104120101
100000161
111111111
