111111111
100000001
104444401
104000401
104120401
100000401
111111601
111111111
