111111111
100000001
104444401
104000101
104120401
100000161
111111111
