11111111111
10300100101
10322220301
10300500301
10302222301
10100100301
11111111111
