11111111111
10300100101
10122223301
10300500301
10332222101
10100100301
11111111111
