11111111111
10300100301
10122223101
10300500301
10132222101
10300100301
11111111111
