111111111
105111111
102030011
100131001
102040001
102031001
111111111
