1111111111111
1000001000001
1020102010201
1011101011101
1020032300201
1330045400331
1111111111111
