1111111111111
1000302030001
1020102010201
1011101011101
1020040400201
1330045400331
1111111111111
