1111111111111
1000001000001
1010221225121
1011101011101
1020031300201
1330030320331
1111111111111
