1111111111111
1000000000001
1210201000121
1011100011101
1002031320201
1632031320331
1111111111111
