1111111111111
1000000000001
1210001000121
1011105011101
1020231320201
1330231320331
1111111111111
