1111111111111
1000030300001
1210201020121
1011105011101
1020231320201
1330231320331
1111111111111
