1111111111111
1000032300001
1210201000121
1011105011101
1020231320201
1330231320331
1111111111111
