11111111111
11000000011
10232323201
10326232301
10323232301
10232323201
11000000011
11111111111
