11111111111
10000600001
10444144401
10400200401
10400000401
11111111111
