11111111111
10000400001
10444144401
10402020401
10300500301
11111111111
