1111111111
1100000011
1062323201
1023232301
1023232301
1032323201
1100000011
1111111111
