11111111
15000001
10444401
10202311
11320201
10433401
10000001
11111111
