1111111111
1110026001
1000023001
1044444001
1100000011
1111111111
