1111111111
1000000401
1000100401
1344444201
1110000051
1111111111
