1111111111111
1000001000001
1044221223401
1003335333001
1044221223401
1000001000001
1111111111111
