1111111111111
1000001152301
1043331122401
1040000020401
1042211443401
1030011000001
1111111111111
