1111111111111
1000000152301
1044433122401
1040000200301
1042214443401
1030010000001
1111111111111
