111111
100001
104301
100201
115141
100201
104301
100001
111111
