1111111
1000001
1044301
1000201
1151141
1000201
1044301
1000001
1111111
