111111
100001
104341
102001
110151
102001
104341
100001
111111
