1111111
1000001
1434401
1002001
1011041
1020001
1434461
1020001
1011041
1002001
1434401
1000001
1111111
