1111111
1000111
1000111
1102001
1644101
1000001
1111111
