11111111
10000001
10433401
10402011
11320401
10444201
10000051
11111111
