111111111
100040001
102040201
101131101
100060001
111111111
