111111111
100040001
102040201
101131101
100040001
111040111
111040111
111040111
111060111
111111111
