111111111
100040001
102040201
101131101
100404001
110404011
110404011
110060011
111111111
