111111111
110000011
100424001
104010401
100404001
110040011
111060111
111111111
