111111111
110040011
100464001
100111001
100040001
104424401
100010001
110010011
111111111
