111111111
110040011
100464001
100111001
100040001
144424441
100000001
110000011
111111111
