111111111
110040011
100464001
100111001
100040001
100121001
110040011
111111111
