111111111
100040001
100464001
110101011
100020001
100010001
111111111
