1111111
1000001
1044401
1015201
1012001
1033401
1001001
1111111
