111111111
151000001
102333201
102121201
102333201
102003131
111111111
