111111111
111300001
102303201
102111201
102303201
105003111
111111111
