1111111
1000001
1033401
1012001
1015201
1044401
1000111
1111111
