11111111111
10000400001
10121112101
10300300301
10121212101
10300300301
14121112141
10300600301
10121212101
10300300301
10121112101
10000000001
11111111111
