11111111111
11000000011
10044644001
10401310401
10040100401
11020204001
11110400011
11110401111
11110201111
11110301111
11111111111
