11111111
10000511
12122411
10230011
10311001
10201001
13030031
11111111
