11111111
10000111
10113111
10230001
10112001
12200101
13060231
11111111
