1111110111111
1000011100051
1044001003301
1020121210201
1033003024401
1000111110001
1111100011111
