11111111
10000001
14113131
10032001
10110201
10202121
13045031
11111111
