1111110111111
1000011100001
1044204004401
1005101010201
1044003023301
1000111110001
1111100011111
