11111111
13000261
10121221
10100201
10300101
12130301
13000011
11111111
