11111111
11620111
11220311
10012031
13000001
11322011
11132311
11111111
