111111111
110023111
100002311
102310011
130110011
113022111
111300401
111112101
111115001
111111111
