1111111111111
1111103201111
1102000000011
1102231320011
1600111132031
1111111111111
