11111111111
11111030011
11002002231
11320113221
13003000451
11111111111
