1111111111
1031000031
1002012031
1301023001
1142212011
1100006111
1111111111
