1111111111
1031030031
1002212001
1301043201
1102012511
1100003111
1111111111
