1111110111111
1000011100001
1044203024401
1005101210201
1044003003301
1000111110001
1111100011111
