11111111111
10454330301
10344144301
10000202001
11220100211
11000100011
11111111111
