11111111111
11300500311
10444444401
10200100201
10000100001
11000100011
11111111111
