11111111111
11300500311
10444444401
10100400101
10200100201
10000100001
11111111111
