111111111
111110011
111000011
111000011
111101111
111102311
100003251
100012311
111110111
111000011
111000011
111001111
111111111
