111111111111
111111310011
111150400011
111111411011
100000200011
100010010001
111111110001
111111111111
