11111011111
10001110511
10002020211
11011311011
11230004001
11030003001
11111111111
