1111111
1005001
1334331
1023201
1020201
1023201
1243421
1003001
1111111
