1111111
1003001
1423031
1523201
1212101
1023001
1322031
1003001
1111111
