111111111
100000001
100310201
116112111
130010201
100040001
100110001
111111111
