11111111
10010001
13050201
13110201
13110201
13000211
11110011
11111111
