1111111
1000001
1350201
1310201
1310201
1300211
1110011
1111111
