1111111
1000011
1620201
1310001
1310201
1000111
1111111
