111111
132001
132001
132001
132001
162111
100011
111111
