1111111111111
1000001540001
1044421242001
1030300232301
1040421234301
1000301000001
1111111111111
