1111111111111
1000001060001
1044421240401
1030003002301
1040421244401
1000301000001
1111111111111
