11111011111
10001110001
10320300301
10001010201
11011011011
11005202011
11011011011
10201010001
10400300301
10001110001
11111011111
