111111111
132010231
104520301
110104011
103202401
130020031
111111111
