111111111
110000001
103343101
103020401
104204101
103245201
101312201
100000011
111111111
