111111111
100000001
101144101
101520401
104220301
104022301
101343311
100000111
111111111
