1111111111
1000000001
1011141101
1015201101
1012100301
1040240301
1040200301
1043444101
1100000001
1111111111
