1111111111
1000000001
1011144101
1015200401
1012102401
1040400401
1030201101
1033431101
1100000001
1111111111
