1111111111
1000000001
1011134101
1013002301
1010120301
1042200301
1045201101
1014441101
1000000011
1111111111
