1111111111
1000000001
1043433401
1040222001
1141251311
1002020401
1043344401
1000000001
1111111111
