1111111111
1000000001
1044444301
1045200301
1142212311
1032020301
1044344401
1000000001
1111111111
