1111111111
1000000001
1043444401
1030025401
1142212411
1032000301
1043444401
1000000001
1111111111
