1111111111
1000000001
1044444401
1540201401
1140200411
1031020301
1044344401
1000000001
1111111111
