1111111111
1000000001
1046444401
1041000401
1130222411
1041200301
1044344401
1000000001
1111111111
