11111111111
10000010011
10434212011
10303020001
10404215001
10003011111
11111111111
