11111111111
10000010001
10444210101
10400060001
10404211111
10003011111
11111111111
