11111111111
10000100001
10202300401
10621110401
11101110111
11101113111
11101110111
10301112301
10202300401
10000100001
11111111111
