11111111111
10011111111
10500333331
10211112111
10011102001
10200102201
10013000001
11111111111
