11111111111111111
11111100111111111
11111020011111111
11110232001001111
11102323200113111
11023232320030311
10232323232306031
10023232320030311
11002323200113111
11100232001001111
11110020011111111
11111000111111111
11111111111111111
