11111111111111111
11111000000000011
11111040404040011
11111004040404011
11111040404040011
11111004062404031
11111040404040011
11111004040404011
11111040404040011
10200004040404011
10001000000000011
11111111111111111
