1111111111111
1000000000011
1040404040011
1004040404011
1040404040011
1004042404031
1040454040011
1004040404011
1040404040011
1004040404011
1000000000011
1111111111111
