111111111111
100000000001
104040404301
102404040401
104040404001
100404040401
104040404001
100404040401
104040404201
106404040401
100000000001
111111111111
