11111110001111111
11110001010001111
11100400100400111
11004040004040011
10040004040004001
10400600400200401
10040004040004001
11004040004040011
11100400100400111
11110001010001111
11111110001111111
