1111101111111111
1300101001111111
1300111002001111
1000011020001111
1100001100000011
1110000110000011
1011000010000011
1001101011101111
1000101000000001
1000050000000001
1000100000000111
1001111110011111
1011000011111111
1111111111111111
