1111110111111
1110001000111
1100100010011
1004040404001
1010001000101
1040601020401
1010001000101
1004040404001
1100100010011
1110001000111
1111110111111
