11111111
11000131
11020031
11101141
10200031
10101141
10120031
10200131
10110201
10500001
11111111
