111111111
100000001
104444601
104001401
104000401
104000401
102444401
110000001
111111111
