1111111111
1000000001
1044444601
1040000401
1040110401
1040110401
1040000401
1024444401
1100000001
1111111111
