11111111111
10000000001
10444444601
10400000401
10401110401
10401010401
10401100401
10400000401
10244444401
11000000001
11111111111
