11111111111111111
11111111110000001
11111111110444601
11111111110400401
11111100000400401
11111104444044401
11111104000400001
11111104010401111
10000004000401111
10444440444401111
10400004000001111
10401104011111111
10401104011111111
10400004011111111
10244444011111111
11000000011111111
11111111111111111
