1111111111111111
1100000011111111
1024444010000001
1040004010444601
1040104010400401
1040004000400401
1044440444044401
1000004000400001
1111104010401111
1111104000401111
1111104444401111
1111100000001111
1111111111111111
