1111111111111111111
1000000000000000001
1040404040404040401
1004040404040404001
1111111111111112011
1004040404040404001
1040404040404040401
1004040406040404001
1000000001000000001
1111111111111111111
