1111111111111111111
1000000010000000001
1004040040040424001
1040404010404040401
1024040010040404001
1040404010404040401
1004042010040404001
1111101111111110411
1004040010040404001
1040404010404040401
1306040310040404001
1001000010000000001
1111111111111111111
