11111111111111111
10003000300030001
10121212121212101
10303030503030301
10121212121212141
10303030003030301
10121212121212141
10303030003030301
14121212121212101
10003000300030001
11111111111111111
