1111111111111
1113331333111
1113311133111
1113311133111
1110000000111
1110000000111
1111100011111
1111100011111
1111110111111
1000000000001
1000202020001
1102020202011
1120202020211
1100025200011
1100111110011
1111100011111
