111111111
100000001
104040401
100323001
104242401
100323001
104040401
100000051
111111111
