11111111111
10000000001
10404240401
10030403001
10404040401
10240404201
10404040401
10030403001
10404240401
10000000051
11111111111
