11111111111
10000000001
10404340401
10020402001
10404040401
10340404301
10404040401
10020402001
10404340401
10000000051
11111111111
