111111111
111050111
110020011
100202001
102020201
110202011
111343111
111333111
111333111
111111111
