111111111
111050111
110020011
100202001
102020201
110202011
111040111
111303111
113030311
111303111
111131111
111111111
