11111111111111111111
11111111111111111111
11111111111111111111
11111111111111111111
11111111110000051111
11111111110212011111
11111111110200211111
11111111111202011111
11111111110201011111
11333300110200200111
11133300002002000111
11333300111111111111
11111111111111111111
11111111111111111111
11111111111111111111
11111111111111111111
