11111111111111111
11110000000001111
11100100000100111
11002010001020011
10020201010202001
10202020002020201
10020201010202001
11002010201020011
11110102020101111
11110043434001111
11110134343101111
11110133433101111
11110133633101111
11110113131101111
11100033333000111
11100011111000111
11111100000111111
