1111111111111111111
1000000000000000001
1644444444444444401
1000000000000000401
1111111111111110401
1000000000000000401
1044444444444444401
1040000000000000001
1040111111111111111
1040000000000000001
1044444444444444401
1000000000000000401
1111111111111100401
1002040404040444401
1000000000000000001
1111111111111111111
