11111111111
10000011111
14464411111
10040011111
10040011111
11040111111
11040111111
11040111111
11040111111
11040111111
11040101111
11040110001
11040000201
11044444401
11000000001
11111111111
