1111111111111
1100000000001
1024444444401
1040004000401
1040104010401
1040004000401
1044444444401
1000400040001
1110401040111
1110400040111
1110444460111
1110000000111
1111111111111
