11111111111111111
11000000000000001
10244444444444401
10400040004000401
10401040104010401
10400040004000401
10444444444444601
10000000000000001
11111111111111111
