11111111111111111
11111100000011111
11111024444011111
11111040004011111
11111040104011111
11100040004000111
11104444444440111
11104000400040111
11104010401040111
10004000400040001
10444444444444401
10400040004000401
10401040104010401
10400040004000401
10444444444444601
10000000000000001
11111111111111111
