11111111011111111
11000000100000001
10244440104444401
10400040104000401
10401040104010401
10400040004000401
10444444444444401
10000040004000001
11111040104011111
10000040004000001
10444444444444401
10400040004000401
10401040104010401
10400040104000401
10444440104444601
10000000100000001
11111111011111111
