111111111111111111
111110000000000011
111100111011111001
110001000100000101
100101012121210101
101000020200000101
101011110110100101
101200020001000101
100021010101012101
110001010001000001
111011210121211111
111133333533333331
111111111111111111
