111111101111
103333010001
103113212001
104113010201
103023212001
102113000001
100113211111
102013010001
105013210201
110013000201
131113211211
133333020201
132001000201
102221200001
100001000001
111110111111
