1111111111111
1100000000011
1004444444001
1040000000401
1041210131451
1040000000401
1004444444001
1100000000011
1111111111111
