1111110111111
1100001000011
1034400044301
1041044401401
1040002000401
1004001004001
1104211124011
1004001004001
1040002000401
1041044401401
1034405044301
1100001000011
1111110111111
