11111111
11001111
11001111
10323111
10252001
11323001
11100111
11111111
