11111111
11100111
11100111
10323001
10252001
11323111
11100111
11111111
