111111111111111
110000100001111
110020011110001
111210030000201
111000131112111
111110163000111
111000331011111
111211131000111
102000030012111
100011110020011
111100001000011
111111111111111
