11111111
11100111
11100111
10323001
10202001
11623111
11100111
11111111
