11111111111111
11000000000001
11012202020201
11020111111101
11010000000101
11000202020201
11000111111411
11021020202311
11320000000311
10311111111311
10333333333611
11111111111111
