111111111111111
111110040011111
110132020231011
131320020023131
100261313132001
102013131310201
100100020001001
141322101223141
100100000001001
102010121010201
100231333132001
131320020023131
110132020231011
111110040011111
111111111111111
