1111111111
1000000051
1012222101
1023333201
1023333201
1023333201
1023333201
1012222101
1100000001
1111111111
