1111111111111111111
1333313331333133331
1322214231423142231
1302300223022002031
1340310001000133231
1110111111111110111
1332010005000100431
1322010222220102231
1302010202020100231
1323010202020102331
1110110202020111011
1332310202020134031
1322000202022132231
1302412202020020231
1333310000000133331
1111111111111111111
