1111111111111111111
1003003000300300001
1011111111111110131
1000030030030020101
1010111111111012131
1312002020202013101
1010102020202010101
1313102020202013131
1010102020202010101
1010122020202240131
1313102005000000001
1010101111111111101
1310003003000300401
1010111111111111101
1000030030003003001
1111111111111111111
