1111111111111111111
1111100000000000001
1111105020202020201
1100111002202020201
1130200100202020201
1331020010022020201
1331002001002020201
1343110200100220201
1334310020010020201
1343431102001002201
1334343100200100201
1343434311020011211
1334343431002011001
1043434343100202001
1333333333330000001
1111111111111111111
