11111111111
11000000011
11022222011
11010131011
10010030011
10211131111
10233363331
10210131111
10010131001
11110131201
11022202001
11000000011
11111111111
