11111011111
11100100111
11000200011
13032323031
10323232301
10232323201
12023232021
10010601001
11101110111
