1111111111111
1111105011111
1113020203111
1130234320311
1102010102011
1023100013201
1003201023001
1023100013201
1102010102011
1130234320311
1113020203111
1111100011111
1111111111111
