1111111111111111111
1001031333331301001
1021230033300321201
1001030001000301001
1020010001000100201
1010200100010020101
1002021000001202001
1000103116113010001
1022123000003212201
1000100100010010001
1022123001003212201
1000001001001000001
1021111011101111201
1020000002000000201
1001330331330331001
1111111111111111111
