1111110111111
1000301030001
1040404040401
1000405040001
1144444444411
1000400040001
1040404040401
1000400040001
1144244424411
1000400040001
1040404040401
1000100010001
1111011101111
