1111111
1100001
1034601
1040401
1024201
1100001
1111111
