111100000000001111
100111111111111051
100333333333333331
102111111011111131
100102002220010131
102102000201010131
100102010201010131
102102010201010131
100102010201010131
102102010201011131
100102010201000131
102102010201010131
100102010200000131
102001010111111131
100111000100000131
111101111100000111
