1111110111111
1000301030001
1040404040401
1000405040001
1144244424411
1000400040001
1040404040401
1000400040001
1144244424411
1000400040001
1040404040401
1000301030001
1111110111111
