111111111111111
110000000000011
106044404440201
104440444044401
100000000000001
111111111111111
