11111111111111
11000000000011
10604440444011
10444044404001
10000000004401
10111111100401
10000000004401
10444044404001
10204440444011
11000000000011
11111111111111
