111111111111
100000000011
104440444011
104044404001
104000004401
102111100601
104000004401
104044404001
104440444011
100000000011
111111111111
