11111111111
10000000001
10444044401
10404440401
10400000401
10201110601
10400000401
10404440401
10444044401
10000000001
11111111111
