11111111111111
10000000001111
10444044401111
10404440401111
10400000400001
10401310444251
10400000400001
10404440401111
10444044401111
10000000001111
11111111111111
