11111111
10011111
10033611
10010111
11010001
10010201
10202101
10010001
11111111
