1111111111
1116301111
1111300201
1111310201
1111312101
1001310001
1021311011
1002020201
1000000001
1111111111
