1111111111
1163301111
1111300201
1111310201
1001310201
1021312101
1001310001
1021311011
1002020201
1000000001
1111111111
