11111111111
11100000001
11101010101
10600404001
10101010101
10100404001
10201010101
11100000001
11111111111
