111111111
110000011
110161011
100404001
104040401
104020401
104020401
104242401
100303001
111030111
111000111
111111111
