111111111111111
100000000000001
101111111111101
101000000005101
101011111110101
101000000010101
101111111010101
100020003000101
102011131311101
102010033300101
102010101010101
102010001000101
102011111111101
101000000000001
111111111111111
