111111111
100000001
104444401
104000401
106021011
104000401
104444401
100000001
111111111
