11111111111
11000000011
10044444001
10401010401
10404040401
10400200401
10040104001
11004640011
11100000111
11111111111
