1111100011111
1100010100011
1004001004001
1043405042401
1004001004001
1100010100011
1111100011111
