111111111
110010011
114050411
100010001
103212301
100040001
111111111
