111111111
110010011
114050411
100040001
103212301
100010001
111111111
