111111111
100050001
103444301
100232001
102030201
104444401
100010001
111111111
