111111111
100010001
102210601
104040301
103040401
103012201
100010001
111111111
