111111111
100000001
134444421
102000301
104454401
103000201
124444431
100000001
111111111
