111111111
100010001
106414401
104002301
104020401
104020401
104413401
100010001
111111111
