11111111111
11001111111
11000252011
11011411011
10010301011
10003341011
11010400001
11211310001
11000002011
11110011111
11111111111
