11111111111
11001111111
11000252011
11011411011
10010301011
10023330001
11010301001
10011311211
10020020001
10010010001
11111111111
