111111111
100111111
102520011
102141011
100333201
110131001
100000001
100001111
111111111
