111111111
100111111
102002011
105141011
102433001
110131001
110000001
111100111
111111111
