111111111
100111111
102002011
100141011
152333001
112131001
110000001
111100111
111111111
