11111111111
11000000011
11211311211
11010003001
10010311001
10032001011
11011311211
10000000251
10001001001
11111111111
