11111111111111111
11111001111111111
11111001111111111
11111000000001111
11111101111101111
10001124444101111
10000023334101111
10111123334100001
10000023334111101
11111122222000101
11111000101050101
11111011101011101
11111000100010001
11111110111110111
11111110000000111
11111111111111111
