111111111
110000011
112131011
115103001
112131001
100401001
100131001
102020001
110000011
111111111
