111111111
110000011
112131311
110103001
110131201
102321011
103161001
102220001
110000011
111111111
