111111111
100000011
101341211
103003001
104013201
101331011
111222211
111500011
111111111
