1111111111
1000001111
1022120111
1013400111
1013120001
1013333101
1002113101
1115233101
1111212201
1111000001
1111111111
