1111111111
1000001111
1022120111
1013452111
1013122001
1013433101
1000113101
1110043101
1110210001
1111000001
1111111111
