111111111
100000001
100344201
103025401
104111401
103000401
102434201
100010001
111111111
