1111111111111
1000001111111
1043401111111
1040301111111
1042400111111
1000420030201
1111103042401
1111111040401
1111111246401
1111111000001
1111111111111
