111111111
100001111
101101111
100323111
111252001
111323101
111101101
111100001
111111111
