11111111111111111111
11111111111111111111
11111111111111111111
11111330011115111111
11111330011100011111
11111330000022011111
11111330010102011111
11111331110102011111
11111111020120011111
11111111002102011111
11111111020020011111
11111111001100011111
11111111111111111111
11111111111111111111
11111111111111111111
11111111111111111111
