11111111111
10000004001
10040404041
10404040451
10040404041
10404000001
10040111111
10404111111
10040111111
10423111111
10000111111
11111111111
