11111000011111
11100111100111
11100000000111
10022222222001
10023333332001
11023133132011
11023311332011
11023311632011
11023133132011
10023333332001
10022222222001
11100000000111
11100111100111
11111000011111
