1111111111111
1000000011111
1044444011111
1040004011111
1040604011111
1040004000001
1044442444401
1000004000401
1111104010401
1111104000401
1111104444401
1111100000001
1111111111111
