1111111111111
1000000011111
1064444011111
1040004011111
1040104011111
1040004000001
1044440444401
1000004000401
1111104010401
1111104000401
1111104444201
1111100000001
1111111111111
