11111111111111111111
11111111111111111111
11111111111111111111
11111111111000111111
11111010511022011111
11110000200000011111
11110020011100011111
11111101111121111111
11110200111033111111
11110202020333111111
11110000111333111111
11110220111333111111
11110011111111111111
11111111111111111111
11111111111111111111
11111111111111111111
