11111111111
10000000111
10444440111
10400040111
10401040111
10400040001
10644144201
10004000401
11104010401
11104000401
11104444401
11100000001
11111111111
