111111111
110000011
105222211
102333431
102310231
102300231
102422231
111333311
111111111
