111111111
160000011
101222211
102333431
102320231
102300231
102422231
111333311
111111111
