11111111111
11100000111
11101010111
10060404001
10101010101
10040404001
10101010101
10040402001
11101010111
11100000111
11111111111
