111111
100011
101011
100011
161011
102001
132101
110001
111111
