111111111111111
111110011111111
111100020111111
111100010111111
111100130000011
111101312100001
110002000310001
112131050131211
100013000200011
100011213101111
110000031001111
111101010001111
111100020001111
111111110011111
111111111111111
