1111100011111
1100010100011
1101010101011
1102010102011
1131311131311
1002300032001
1021211121201
1003005003001
1111111111111
