1111111111111
1111100011111
1111101011111
1111102011111
1111131311111
1000302030001
1012121212101
1000302030001
1111131311111
1111102011111
1111101011111
1111105011111
1111111111111
