11111111111111111
10000000000111111
10202343402011111
11020434320201111
11102343404340111
11110434323432011
11111020204340201
11111100000000051
11111111111111111
