111111111111111
100000011001001
102002001001001
100220221001001
112000500000001
110020023333301
111001003313311
111111111111111
