1111111111
1100000111
1100220011
1110200211
1112202201
1110000001
1111151111
1033101111
1000000111
1100100111
1111001111
1110003111
1113003111
1110113111
1113113111
1111111111
