11111111111111
11000001111111
11312200000111
11000002222111
10233100300251
10300323312011
10011000030111
11311000110011
11111130002011
11111100111111
11111111111111
