11111111111111
11111001111111
13330001111111
13333030031111
13333010011111
11111110111111
11000002200111
11020120002111
11020102020001
11110102202101
11110020050101
11102011110001
11100011111111
11111111111111
