111111111111111111
111111111110005011
111111111100022011
111113331001220111
111113331220020011
111113330002101011
111111001102001011
111111101100011011
111111101111111011
111111101100011011
111111101122001011
111111101020203311
111111100002002111
111111000200000031
133310012001311101
133312200200300201
133000021010330201
110011020010111111
111011000110111111
111011111110111111
111011000110111111
111011220010111111
111010202033111111
111033020021111111
111112010000311111
111110013111011111
111111003002011111
111111113302011111
111111111111111111
