111111111
110000001
130110101
102020101
120104101
102020101
101105101
100013101
111333001
111111111
