1111111111111111
1111111111113311
1111100000033331
1111100121003331
1111110101101131
1111110105001131
1000110111110031
1020000000000111
1022210111111111
1000010000111111
1111100220111111
1111102020111111
1111004020111111
1111010000111111
1111022001111111
1111100011111111
1111111111111111
