1111111111111111111
1111111111001111111
1111333002033333111
1111100121033333111
1111112031033333111
1100052011033333111
1100011001011111111
1120211000011111111
1102011002111111111
1000211102000111111
1002010002020001111
1110010120221201111
1110010200001020001
1110211110001000201
1110011111111110111
1110220000000000011
1110201111111100011
1111001111111110011
1111111111111111111
