11111111111111111
11111111333311111
11111133333303111
11111133333323111
11111133333313111
11111111131313111
11000013331314111
11022000202000011
11001211211012011
11022020200020011
11001010111112111
11021020200010111
10250020201002001
10022200220202001
10000102100120111
10200002000000111
10000111111111111
11111111111111111
