111111111111111111
111100001003001111
111102021220121111
110020032530102001
110022013413400201
110131314311102001
110331434313101201
110043334334422001
100244343323101001
102334311331102001
100113111111101201
111110202020020001
111110020000022201
111111111110000001
111111111111111111
