111111111111111
111111000111111
100000000000001
103232323232301
131212151212131
113232323232301
111000000000001
111111000111111
111111111111111
