1111111111111111
1111111000111111
1100000000000001
1103232023232301
1000202050202031
1030404040204011
1312000000011311
1132323030023111
1111111111111111
