11111111111111
11111020000331
11110002013031
11020000000331
10002013000101
10010200002001
11011020001201
11201002001021
11021050201101
11002330020101
11010403102001
11330343000201
11313102000111
11333000201111
11111111111111
