11111111111111
11333311111111
11333331311111
11333341311111
11333334311111
11333322020011
10003000222001
10022020020001
10002002222001
10022025200201
10202000000001
11020020111111
11002020111111
11100011111111
11111111111111
