1111111111111
1111100011111
1111100011111
1000002000001
1001210121001
1101334331011
1122334302211
1100300000011
1101203021011
1000002000001
1001200021001
1101334331011
1122334332211
1101310430011
1101214121011
1100002000011
1111005001111
1111111111111
