111111111111
111111001111
111111021111
111005001111
100033221111
102133130201
102031331201
111122330001
111100000111
111120111111
111100111111
111111111111
