111111111111
100000000001
100000020001
102022222201
100113350201
100313333201
100433343001
100143434201
101133100001
102021102211
100000000011
111111111111
