111111111111111
111111111100011
100001100001011
101101142221011
100200230200011
100221333101111
100203133020011
100203363001001
101123132002001
100200030222001
100002331002001
100224411301101
110133303333001
110003031302001
111101333122001
110002032002001
110122241101101
110100001100001
110000111111111
111111111111111
