111111111111111
111110010011111
111110222011111
111110023011111
100010252010001
120200020002021
131011232110131
132220020022231
134321232123431
133333333333331
111111111111111
