1111111111111
1113334333111
1130105010311
1332222222331
1130032000311
1111122211111
1111002001111
1111002001111
1110002000111
1110222220111
1111103011111
1111133311111
1111111111111
