11111111111
10001113111
10022033331
10220243131
11021531131
11020013431
11002204331
11022002211
11000000011
11111111111
