111111111111
111111110011
111110200001
111110020001
111110111111
111150111111
111110111111
110010111111
102010111111
102000103311
100000000311
111111000311
111111111111
