111111111111111
111100111100001
111120111002101
111520000000001
111121111111101
111101111111101
111101111111121
111101111111101
100001111111101
101121111111101
100000033300001
111000011111131
111111311111111
111111311111111
111111111111111
