1111111111111111111
1500110013300000331
1020112013300000331
1020002011101101111
1001102000002000011
1021100011100002011
1020000200300101111
1000011111121102011
1020011310200000011
1111010310200201111
1100020310011111111
1001000300010000001
1002020310000202001
1331000310211111331
1332020310011111331
1111111111111111111
