1111111111111111111
1500000000001000031
1020002020202000031
1111020200201110031
1003332111111110231
1021330010000011131
1001330010200200101
1001330012111100101
1021330000001100101
1001330010100201101
1021111110112020101
1003320200202020101
1000310000100000131
1002311111111111111
1000000000000000331
1111111111111111111
