1111111111111111111
1111100000111111111
1111101112111100331
1020002000000000331
1000101101111100331
1110121101111111111
1110000201111111111
1115120201111111111
1111100211111111111
1110020201111111111
1110101101111111111
1000101101111100331
1020020000000000331
1111111111111100331
1111111111111111111
