1111111111111111111
1613111110000000001
1313100200011000201
1000001200011112011
1000220011200010001
1020010002010210001
1010000000002011001
1011011112110000201
1010213333310120001
1020023344302101101
1010013333310001101
1020011101011101101
1002200100000100101
1100110002102003331
1111111100100003331
1111111111111111111
