1111111111111111111111
1000000000000000000001
1010111111000001100001
1010020202022000202111
1010002520003134300111
1010120202111333111111
1010002020011333111111
1011122202011333111111
1000001011011333111111
1111100011011333111111
1111111110000011111111
1111111110000011111111
1111111111111111111111
