1111111111111111111
1001111111111111111
1001000331333333111
1001010111110333111
1121000033333333111
1000112111111001111
1020100000111111511
1120102000111111011
1002012221100000011
1000000100001212111
1011110122222000011
1010000200000100011
1010001101100000111
1011111121111110201
1000000001111110001
1111111111111111111
