1111111111111111111
1111111330000100011
1111113340200002011
1111133431111120111
1111334311111020011
1111333111100001011
1001101111100000011
1052020111111010111
1020002000111000111
1112200010111011111
1110002000111011111
1110210111110000001
1112000111110001001
1110011111111000001
1110011111111000011
1111111111111111111
