1111111111111111111
1000010000011111111
1022212222011111111
1002000002011111111
1022012022011111111
1002010000013313331
1101111111013313331
1002010000013313331
1000020200110033331
1020212223000003331
1000010000110511111
1111111111111111111
