111111111111111111
111100000000000001
111021111002102001
131330000225111001
133331021022100201
131311001020102001
133333021200121111
131311001002002001
130331220020100001
100000011000100111
111111111111111111
