11111111111111
11001100010001
10020002000001
10210212002211
10000000201511
10221111121111
11101333100111
10201333333111
10101002133111
10201002333111
10201101333111
10200001111111
10000001111111
11111111111111
