11111111111111111
11333030010030311
13111212010210131
13102015211012131
10201012001000001
12000000201012121
10000112011200201
10202100010010131
13100102000200031
13102111011121231
11330333011303001
11111111111111111
