11111111111111111
11110000100011111
11110100002011111
11110200101111111
11111110101000001
11020000000020001
11010100011110011
11000100010011011
11110110030001011
10020011111001001
10102002001001201
10020020001001001
11510110111001111
11110000113033311
11111111113333311
11111111111111111
