111111111111111111111
110010000000000000011
112010011112111111011
110200200000000000001
110200011101212111201
110100200101010000001
110151210001011000011
110111000101013330111
100200111101013113111
100002000021003333111
111120001020003113111
111100001001003333111
111111111111111111111
