1111111111111111111
1110000010000000011
1100202012010210001
1101111010012000201
1101511020000010211
1022202002100010011
1001011020111111111
1001011002010011001
1111002220033333301
1020011001311311331
1021000201311311131
1000012001311131131
1100110021331131131
1120201200033333301
1100000001001100111
1111111111111111111
