1111111111111111111111
1000111111111000110001
1020000002000000200001
1011111121201011111111
1511001101021201000001
1100000002000020002001
1131331110100111012211
1333333110002111000011
1131131112110111211011
1333333110000111000011
1133131110212111001211
1100000000000200000201
1100111111111100010001
1111111111111111111111
