1111111111111111111111111
1000100003313133111111111
1002120003313133000201111
1022000013333333100101111
1101100113333333110002011
1000000201133311022112011
1022101000113110010110011
1020100100011110020000011
1000000012011100000011211
1111120000001001011010011
1000101110002011010010011
1000200010201002000020001
1111102012220210000010001
1111100010010020001111111
1111111110510011111111111
1111111111111111111111111
