1111111111111111111
1111111110100111111
1111110511100111111
1111000000000111111
1110020001101111111
1100121100000111111
1101000000101111111
1100020100100011111
1111020010000010001
1111011000000000001
1000001110011111111
1000001011111111111
1000001111111111111
1033331111111111111
1111111111111111111
