11111111111
10001001001
10002002001
11211311001
10010311011
10043334001
10010301001
11211311211
10002020001
10001510001
11111111111
