111111111111
111000000111
100200200201
102111020201
100133102001
101333312201
101333332001
102533312001
100133100201
102111020201
100000000001
111111111111
