11111111111111
11111100011111
11111001001111
11110021200111
11110002002011
11020310130001
10202133310201
10110333302211
10002133310001
11000311330001
11100002020011
11110211120111
11111001001111
11111100011111
11111115111111
11111111111111
