11111111111111111111
10000000000000000001
10120002011002002101
10020020020020200001
11111011111111111011
10020002011002000001
10212010001021021201
10020002001002000001
10000200201501110111
11110111111111020001
11110102020202000001
11100333333333000001
11101333333333000001
11100333333333000001
11111111111111111111
