1111111111111111111
1110000000000000111
1112201110111020111
1100111110111112011
1102201110111002011
1100000002000000011
1112000211100000111
1110020201022002111
1110011005001120111
1112001111111100111
1110000011100000111
1111000001022011111
1111111333231111111
1111111433331111111
1111111333341111111
1111111334331111111
1111111313131111111
1000000233320200001
1000000003000000001
1111111111111111111
