11111111111111111111111
11110001111111110001111
11100020111111100200111
11021100011111002112011
10000202001110020002001
10022112002520301122201
10220110001110001102001
11034320011111023343011
11133333111111133333111
11113331111111113431111
11111111111111111311111
11111111111111111111111
