1111111111111111
1110000100000031
1110022103003001
1000220000000001
1000200100030001
1000020113001311
1501111111111111
1111111111111111
