11111111111111
11111100111111
11111100000011
11111101112211
13300101000001
10000000015001
13300101000001
11111101112211
11111100000011
11111100111111
11111111111111
