111111111111111111111
111111100111111111111
111111120000011111111
111111000111011111111
111111021001011111111
110000000200001001111
110111011211051021111
110100233331010001111
110100133331000120201
100010133332200000001
102000133331011021101
111112112111000200001
111110002000000011111
111111010011011111111
111111001100011111111
111111100001111111111
111111111111111111111
