1111111111111111111111
1111111111111111001111
1100102000000000004011
1100000002002000000011
1101511111111111110111
1131111100100111110111
1101000000100000100011
1131001113101100100011
1111101113101101111011
1111101111101101111001
1000001100100100000001
1001001100000100111111
1101021001111111100111
1101001000000000000111
1101111111111111110011
1100000000000000000011
1100111111111111111111
1111111111111111111111
