111111111111111111
111111111000111311
111110000020011211
111110210010010001
111110202002010201
133311100000110201
133011101011110111
133005001010000111
130010111010010111
111110110211010111
111110110000010111
111110111110010111
111110111111110011
111110000000000011
111110011111111111
111111111111111111
