111111111111111111
111111111115011111
111111111110201111
113330011102021111
113333011100001111
113113111111101111
113003000000020011
110110111101002001
110110111101000201
110000111101011111
110201111100011111
112121000112011111
100201010110011111
101000000111111111
101001101111111111
101111101111111111
100000001111111111
111111111111111111
