1111111111111111111
1111111000000001111
1000510010111101111
1011110210111100011
1011002012000101011
1000010000010200211
1110111111011111011
1110000000000000011
1110111111111111011
1110111111100111011
1110111111100000201
1110100011101011101
1110001011121011101
1110111003000200001
1130011011002101101
1330011011002000001
1333333000011111111
1111111111111111111
