111111111111111111111
111100111111111001111
111100001111100001111
111100100050001001111
111110101111101011111
111004340010043400111
111023432010234320111
111110101111101011111
100100100111001003001
102100200111002001201
100003100111001001001
111111111111111111111
