11111111111111111111
11111111100001111111
11111111101102000011
11111111100122021011
11111111110000201011
11111111110111000011
11111111110111111011
11001100000000000011
10000201111111111001
10220011111133333001
11001011111151111111
11021000331111111111
11000020331111111111
11022201331111111111
11000011331111111111
11111111111111111111
