11111111111111111111
11000111111001111111
11510111102000200011
11110100001001020001
10000101101201101101
10000002000200020001
13311122110211201111
13313100102000201111
13333102200011201111
13333100111110001111
13331110000000011111
11111111111111111111
