111111111111
111100000111
111020004001
110434340201
102343434011
100201020111
111005001111
111111111111
