11111111111111111111
10000000000000011111
10210002011002000011
10000211100001022011
13111000002020110011
13331001111000012011
13311221111020010011
13332000000201111111
13330001111111111151
11330021111111111101
11131000000000000001
11111111111111111111
