11111111111
11000000001
11312131201
10000000001
10213121301
10000000001
10312131201
10000500001
10213121301
10000000001
10312131201
10000000001
10213121301
10000000001
10312131201
10000000001
11111111111
