11111111111
10011300001
10202321201
10020302011
10012321011
13333433331
10012321001
11020352001
11212320201
11000311001
11111111111
