11111111111
10010300001
10212321201
10020302011
10002321011
13333433331
11012320001
11020352001
11212321201
11000301001
11111111111
