11111111111
10010300001
10202321201
10020302011
10012321001
13333433331
10012321001
11020352001
11212321201
11000301001
11111111111
