111111111111111111111111
110000100001100001000011
110220102201102201022001
102002020020020020200201
100220002200002200022001
111012011012510112010111
110010310010310010310011
110011110011110011110011
130031130031130031130031
133331133331133331133331
111111111111111111111111
