1111111111111111111111111
1113230010032300100323111
1130203010302030103020311
1022122010221220102212201
1030203001302031003020301
1003231323132313231323001
1100003020310030203000011
1111102212205022122011111
1111103020300130203011111
1111100323132313230011111
1111110001302031001111111
1111111110221211111111111
1111111110302030111111111
1111111110032000111111111
1111111111111111111111111
