11111111111111111111111
11000001111111111113331
11020001111111111113331
10222100001111111113331
10020102000001111003331
11000022210000000003331
10020002010200000001111
10222100002221111013331
10020102000201110013331
11000522210000000013331
10020002010200011003331
10222100002221000003331
11020102000201000001111
11000022210000011013331
10020002011000000013331
10222100000001110013331
11020101111111110003331
11000001111111110003331
11111111111111111111111
