1111111111
1500000111
1110020111
1111101111
1000000001
1020202001
1121111111
1000200331
1000000331
1111111331
1111111111
