1111111111
1511111111
1000001111
1111101111
1000000001
1020200001
1121111111
1000200331
1002200331
1000111331
1111111111
