111111111111111
100000000100011
102200122101011
100102020122011
110100100101011
110011000000011
100010201000111
102012011111111
112010011110001
100200033333331
100011513333331
111111111111111
