11111111
11131131
11021101
11202001
11000001
11001511
13001111
11111111
