111111111111
111100011111
111000011111
111010031111
130222011111
100010030001
100001111101
100001111101
111111111101
111111111151
111111111111
