1111111111111111
1111111133333111
1111111333331111
1111110000011111
1111100200111111
1102021112020111
1100003130000111
1110221112201111
1111000400011111
1111001340011111
1111121112111111
1111102620111111
1111002320011111
1111002320011111
1110001110001111
1100013331000111
1002013331020011
1022203330222001
1002003430020001
1111111111111111
