1111111
1000011
1023201
1036301
1021201
1034301
1020211
1000011
1111111
