11111111111111111
10000011111000001
10132013131043101
10320132320202301
10131320201023101
10023202020202301
10102013131311101
10010111111111001
11010111111111011
11020111111102011
10000000000000011
10313131313101311
10133333333303111
10323232023202311
10122222422221111
10020102020201111
11000000500001111
11111111111111111
