11111111111
10001000111
10002003011
11211101211
11013301011
11003241011
11013332011
11210111001
11005002001
11100111001
11111111111
