1111111111111
1111000001111
1110031300111
1110021200111
1100001000011
1101111421011
1000200020011
1010200000201
1011133331201
1001111111001
1101111111001
1101111111201
1100036300201
1100033300001
1101031321011
1100001000011
1111022201111
1111001001111
1111100001111
1111111111111
