1111111111111
1110001000111
1110002000011
1111211101211
1111013331011
1111003241011
1000003032011
1000200001001
1121000122001
1101333101001
1100324101111
1101333201111
1121011100111
1100500200111
1110011100111
1111111111111
