1111111111111111
1111111511111111
1111111011111111
1111302011311111
1110001111001111
1100013331000111
1002013331020011
1022200000224001
1002003430020001
1111111111111111
