1111111111111
1111113311111
1111020011111
1110000011111
1110111011111
1110111011111
1110111011111
1105230001111
1100113001111
1110111011111
1110232011111
1100232001111
1100032001111
1001111100111
1001111100011
1001111100001
1020333020201
1000111000111
1111111111111
