111111111111
111100511111
100101111111
102101111111
100102311111
133101111111
100100300201
121121110301
100000000001
111000110011
111111111111
