11111111111
15011111111
11011100001
11011121101
11001103101
11021000101
11001000101
11100131001
11000131011
11000020011
11110000111
11111111111
