11111111111
10000000001
10111011101
10100000101
10044444001
11130333111
10024222001
10110101101
10000500001
11111111111
