1111111111111
1111110000111
1111100002031
1111120200001
1511100001131
1011131111111
1003100111111
1003130111111
1023100111111
1002001111111
1022001111111
1000011111111
1111111111111
