1111111111
1300100131
1100120101
1101102001
1121302001
1101101101
1100021101
1101151101
1300000031
1111111111
