1111111111
1300151131
1100120101
1101102001
1101302001
1120001011
1101121001
1101101101
1300000031
1111111111
