1111111111111111
1100000000001111
1120202020201111
1101110020103111
1101333010033111
1001111110000001
1000000050000101
1111111111110001
1111111111111111
