11111111111111111
11110011000011111
11100020010200201
11000211002210001
11000020001000001
11211110111110001
11010333333305011
11030043434301011
10001111110111001
10120000020000201
10001111111111111
11111111111111111
