1111111111
1400004141
1000000141
1004400051
1004400001
1010020201
1410003031
1111111111
