1111111111111
1111110030001
1003000232201
1023220120331
1012033302151
1330213223201
1022320003001
1000300111111
1111111111111
