11111111
15000001
10022021
10210231
10204331
10023131
10233311
11111111
