1111111111111111111
1333000001000013331
1303034201020000231
1303000001002110331
1303031021020100001
1101111001000100001
1100000201020111111
1002020001002000001
1020202021020020201
1002020000500202001
1111111011111111011
1000002003011001011
1002202003331000031
1020220203431003231
1000000010331003331
1111111111111111111
