1111111111111111111
1033131000100010011
1033131020002000211
1033131120103010011
1101131101111111011
1120131000102020011
1020000020020002011
1000101020111011011
1101101115201010001
1002000200200000201
1000202010001311211
1101111111011311011
1100113110201313301
1120002000201313301
1100100010001313301
1111111111111111111
