1111111111111111111
1133311100011133311
1120331120211330211
1022031100011302201
1030231120211320301
1133300200020033311
1100122002002210011
1111100200020011111
1111102020202011111
1100120200020210011
1133300200020033311
1030231120211320301
1022031102011302201
1120331120211330211
1133311105011133311
1111111111111111111
