1111111111111
1111110000011
1111112222001
1111113002201
1100110220051
1000000022201
1300111202001
1331111022201
1331111000001
1333331111111
1333331111111
1111111111111
