111111111111111111
103333100011000001
103333022011022201
113333102011000201
113330000000222001
110110201020002011
110020201202000011
110202000020022001
110020011111120201
110020210002002001
110020010002200001
111021111111002201
113333333311222001
113333336430020201
113333333331000001
111111111111111111
