1111111111111
1111111000111
1111102020011
1111102021011
1111001020011
1111052022001
1111000000101
1001110100001
1000330000211
1001330001011
1000330011011
1101333000011
1100000111111
1111100111111
1111111111111
