11111111111111111
11000000111111111
11011212051111111
10000000010001001
10202011012002201
10111001210213331
10011102000003311
10001112102011111
10202033131111111
10021103433111111
10001103333111111
11111111111111111
