1111111111111111111111111
1510000011111111111110011
1010220201111020200000011
1011100200100000201211311
1000101102000011011001311
1110100020110111011133301
1000110010002111301331321
1011102010220100201333301
1000120202001120201330131
1010200200111000101333331
1012001001111002201333111
1020001111111110001333111
1110011111111111111111111
1111111111111111111111111
