11111111111111111
10033010000110001
10031200120000101
13331021002121001
11011202010030011
11002001002011011
10201011121213031
10101000000013001
10001511111033001
11111111111111111
