1111111111111111111111111
1333110000000001000001001
1333110111111121011203301
1000000111000001020301001
1003111111010100013121211
1301501000010322010001001
1101200002002010012111301
1101011111111111110001001
1101033110000000111101011
1101003112111110111101211
1001000000000000020100011
1000001111211010000001211
1000110001011011111111001
1000000303011002020232401
1111111100011000000000001
1111111111111111111111111
