1111111111111111111111111
1111110000000001000001001
1111110111111102011002201
1300000111000001000201001
1301111111011130012101011
1201111000011111110001001
1501000011111111110111201
1101011111111111110001001
1101011110000000020101011
1101031110111110112101011
1001000000000300000100011
1000001111011010000001011
1000110001011011111111001
1000000101011000003040401
1333111100011000000000001
1111111111111111111111111
