1111111111111111111111
1111111111110001111111
1001111111110101110001
1000000000000000110101
1001110000100000000101
1101001011111100100001
1101000000100100101101
1101001000100100000001
1130000011102111111111
1130001110020200200011
1130111000000200200211
1133331220122202212011
1133331000000001020001
1131331222122210012001
1131332000000000000001
1135331111111111111111
1133331111111111111111
1111111111111111111111
