111111111111111111
111111110000011111
110000010252011111
110001000111111111
110111000000110001
110001330000110101
110111330000000201
110001111011101211
100100001000001011
100000000010011011
100000001110001011
111110000000001011
111111101110001011
111111100000100011
111111111111110011
111111111111111111
