111111111111111111111111
110000000100100000010001
100202010120001112212101
101011102001002020002001
101020000100011000210101
102000111121111110000001
101112111333333111111111
152000111333333333300001
111223333313313111012101
111011111333333110000001
100000001313313110011111
102120121333033102010001
100000201111211102020101
111021200201010200110201
102020010302010010010101
102120002012011000020001
100000100000000010011111
111111111111111111111111
