11111111111111111
11100000001111111
10001012100111111
10211000102111111
10001020200200111
10201101112110011
11100001100000211
11121311101111001
11301020000001001
13302010111000201
13331112111001111
13333310002011501
13333330001111101
11212121111111001
11000000000000011
11111111111111111
