1111111111111111
1111111111110011
1111111111110011
1111111020200211
1111115200000011
1111111101020011
1111033121111011
1100031001000011
1103331002200201
1131300002002001
1130300000000011
1111111010200011
1110331211110011
1000310010010011
1003010022012011
1313000010020011
1300000010000011
1111111111111111
