1111111111111111
1110000003301001
1110000203333331
1111111110113131
1111111100113331
1111001020110011
1111201000100011
1110000000002001
1110000200300331
1110001020103131
1000002000203331
1021001020110011
1100201000100011
1111002002202011
1111101020100111
1111101025101111
1000002002201111
1021101000111111
1100001111111111
1111111111111111
