11111111111111
11030000002001
11330000000001
11311111020001
11310051112111
10012020200001
10000020202201
10013110002001
13030310011111
11311130011111
11111111111111
