1111111111111111
1103000000201111
1130000000001111
1131111102011111
1131000000002011
1111010000000011
1111012020020011
1111310050202111
1303032020200001
1130003020202201
1110013110002001
1113030310011111
1111311130011111
1111111111111111
