1111111
1100011
1031301
1022201
1002001
1103111
1116111
1102011
1103001
1323231
1102001
1100011
1111111
