1111111111111111
1313113111111111
1303333311111111
1333010111111111
1110010111111111
1002000200000201
1020212521200001
1102000201022011
1100111001000011
1111111001111111
1111111111111111
