11111111111
11100100011
11002122011
11000000011
10001210001
10100330101
10303300301
11101310111
11100000111
11122120111
11105100111
11111111111
