111111111111
111100111111
111002020111
111002000111
100001310111
100100300111
100303430451
110101310111
110000020111
111002120111
111100100111
111111111111
