11111111111111111111
11110011111100111111
11100202011002020111
11100200011002000111
10000131000001310111
10010030000100300111
10030343000303430451
11010131010101310111
11000002010000020111
11100212011002120111
11110010011100100111
11111111111111111111
