11111111
10031001
10000001
10024131
11110001
11020111
11500111
11111111
