1111111111
1000000001
1023223201
1000000001
1030000301
1030000301
1000000001
1023223201
1000000051
1111111111
