11111111
11130011
10000031
10230201
10200031
10213201
10230401
10003051
10200201
10000031
11111111
