11111111111111111
11110011111111111
11110011111111111
11000000111111111
10013310011001111
10224422000001111
11003350001001111
11110010001011111
11111110043400111
11111110234320111
11111111101011111
11111111001003001
11111111002001201
11111111001001001
11111111111111111
