111111111111111111
110001000001111111
110100011101111111
110100020000011111
110102211102020001
110112010022202001
110100200100021001
112101110111100011
100000333333111011
101011333333200011
100011333333111011
111111111000102211
111110252010000011
111110000011111111
111111111111111111
