1111111111111111111
1110011111111111111
1110000000000000001
1110020101001021101
1111010000120220101
1111211210201000101
1000033011001101101
1020133300020100201
1100103311100000111
1111110113310111111
1111110130000501111
1111110030010001111
1111111111111111111
