1111111111111
1111111100011
1111110252001
1111110202101
1111100102001
1111100222011
1333100001011
1333111011011
1330000000011
1000111111111
1111111111111
