1111111111111
1111110301111
1111110201111
1111333333311
1111133333111
1111113331111
1111111211111
1111111510001
1111111210101
1111111002001
1111102021011
1111000201211
1110200100011
1102001112001
1020202020201
1000000000001
1111111111111
