11111111111111
10010010010001
13213210200201
10010010111101
10010010300301
15030020000001
10010011000011
11111111111111
