1111111111111111111
1111000000111111111
1111011022111111001
1111011110111100331
1000011100011100131
1011010000011110111
1011000100111110111
1011111150111110111
1010011121100000111
1010211100000100111
1010000003100111111
1011000110111111111
1011111110111111111
1000001110111111111
1111100000111111111
1111111111111111111
