111111111111111111111
100000000000000000001
101111111111111101101
101111111020404030101
100011100010001012001
101005001111100000101
101110130010021014101
101110204040403000101
101111041111140104101
101111001111100100101
101111141111141114101
101111001111100100101
101111041111140104101
101110001111100000101
101110141111131014101
101110001111100000101
101110120010001013001
101100304040404020101
101101111111111101101
100000000000000000001
111111111111111111111
