111111111111111111111
100000000000000000001
101111111111111101101
101110403040404020101
100010120010001013001
101000001111100000101
101110120010031012101
101110304040402000101
101111031111140104101
101111051111100100101
101111141111141114101
101111001111100100101
101111041111140104101
101110001111104000101
101110141111101014101
101000001111100000101
100011130010021011101
101111102040304001101
101111111111111101101
100000000000000000001
111111111111111111111
