111111111111111111111
100000000000000000001
101111111111111101101
101111102040404030101
100011130010001012001
101000001111100000101
101110141111111014101
101110001111111000101
101111041111111104101
101111001111111100101
101111141111111114101
101111001111111100101
101111021111111104101
101020054040403000101
101310130010021014101
101000001111100000101
100210120010031013001
101030304040204020101
101101111111111101101
100000000000000000001
111111111111111111111
