111111111111111111111
100000000000000000001
101111111111111101101
101110403040402040101
100010120010031010001
101000001111100000101
101210140010001014101
101000004040404000101
101401041111140104101
101001001111100100101
101411141111141114101
101001001111100100101
101401031111140104101
101000001111104000101
101410141111101014101
101500001111100000101
100310100010021011101
101020404040304001101
101101111111111101101
100000000000000000001
111111111111111111111
