111111111111
100011111111
101000001111
101210135111
101000204031
101401041111
101001001111
101411141111
101001001111
101401041111
101000001111
101410141111
101000001111
100310121111
101020403111
101101111111
100001111111
111111111111
