111111111111111111111
100000000000000000001
101111111111111101101
101111111111102030101
100011111111131012001
111000001111100000101
111111100010001014101
111111111000454000101
111111111111140104101
111111111111100100101
111111111111141114101
111111111111100100101
111111111111140103101
111111111111103020101
111111111111121014101
111111111111100000101
111111111111111011101
111111111111111001101
111111111111111101101
111111111111111100001
111111111111111111111
