111111111111111111111
111111111111111100001
111111111111111101101
111111111111304020101
111111111111101013101
111111111111100500101
111111111111111014101
111111111111111000101
111111111111111104101
111111111111111100101
111111111111111114101
111111111111111100101
111111111111111102101
111111111111102030101
111111111111131011101
111000001111100011101
100011100010021011101
101111102040304001101
101111111111111101101
100000000000000000001
111111111111111111111
