111111111111111111111
111111111111111100001
111111111111111101101
111111111111111001101
111111111111111011101
111111111111111011101
111111111111111011101
111111111111111000101
111111131111111102101
111111101111111100101
111111141111111114101
111111001111111100101
111111041111111104101
151110001111111000101
101110141111111014101
101110001111100000101
101110120010001013001
101100304040404020101
101101111111111101101
100000000000000000001
111111111111111111111
