1111111111
1000000001
1022212101
1033230301
1011122201
1013363101
1000000001
1111111111
