111111111111111111111111111111111
100000000000000000000000000000001
101111111111111111111111111101101
101111111111111111111111102030101
101111111111111111111111101012101
101111111111111111111111100500101
101111111111111111111111111014101
101111111111111111111111111000101
101111111111111111111111111104101
101111111111111111111111111100101
101111111111111111111111111114101
101111111111111111111111111100101
101111111111111111111111111104101
101110304040404040201111103020101
101310120010001010131111121013101
101000001111100000001111100000101
100210131111111101120010031110001
101030201111111100304040201111101
101101111111111110111111111111101
100000000000000000000000000000001
111111111111111111111111111111111
