111111111111111111111111111111111
100000000000000000000000000000001
101111111111111011111111111101101
101110203040404004001111111001101
100010140010001101101111111011101
101000001111100000001111100000101
101410130010021010120010001014101
101000204040403040403040404020101
101401041111140111041111111103101
101001001111100111001111111100101
101311141111141111141111111114101
101501001111100111001111111100101
101401041111130111041111111104101
101000401111104040001111102030101
101410101111121010141111131012101
101000001111100000001111100000101
101210120010031101130010021010001
101030203040402000204040304011101
101101111111111110111111111111101
100000000000000000000000000000001
111111111111111111111111111111111
