1111111111111111111
1000000000000000111
1011111111111110111
1011111020404035231
1000111300100011011
1010000011111000011
1011101411111111111
1011100011111111111
1011110411111111111
1011110011111111111
1011111411111111111
1011110011111111111
1011110211111111111
1011100011111111111
1011101111111111111
1010001111111111111
1000111111111111111
1111111111111111111
