111111111111111111111111111111111
100000000000000000000000000000001
101101111111111011111111111101101
101020304040403002004040402030101
100310120010001101100010031012001
101000001111100000001111100500101
101410140010001010100010041010101
101000004040404040404040400040101
101401041111140111041111140104101
101001001111100111001111100100101
101411141111141111141111141114101
101001001111100111001111100100101
101401041111140111041111140104101
101000404040404040204040403000101
101410100010001010130010021014101
101000001111100000001111100000101
100210130010041101120010001013001
101030204040400000304040404020101
101101111111111110111111111101101
100000000000000000000000000000001
111111111111111111111111111111111
