111111111111111111111111111111111
100000000000000000000000000000001
101101111111111011111111111111101
101100111111111002303040201111101
101110111111111101120010031110001
101110001111100000001111100000101
101110100010001010131111141011101
101030404040402040401111100011101
101201111111111111021111140111101
101001111111111111001111100111101
101411111111111111141111141111101
101001111111111111001111100111101
101401111111111111031111140111101
101000102040311110204040403011101
101410130011111110140010021011101
101000001111111100001111100011101
100310121111111101111111111011101
101020301111111100111111111001101
101101111111111110111111111101101
100000050000000000000000000000001
111111111111111111111111111111111
