111111111111111111111111111111111
100000000000000000000000000000001
101101111111111011111111111111101
101100102040404003001111111111101
101110130010001101121111111110001
101000001111100000001111100000101
101410121111111111130010021011101
101020301111111111102040403011101
101301111111111111111111140111101
101001111111111111111111100111101
101211111111111111111111141111101
101001111111111111111111100111101
101101111111111111131111130111101
101100111111103040404040402011101
101110111111121010120010041011101
101110111111100000001111100000101
101110111111131101101111111110001
101100111111102000351111111111101
101101111111111110111111111111101
100001111111111110000000000000001
111111111111111111111111111111111
