111111111111111111111111111111111
100000000000000011111111111111111
101111111111111011111111111111111
101111111111111001111111111111111
101111111111111101111111111111111
101111111111111100111111111111111
101111111111111110111111111111111
101111111111111110203111111111111
101111111111111111021111111111111
101511111111111111001111111111111
101311111111111111141111111111111
101001111111111111001111111111111
101201111111111111041111111111111
101030404040201110204040403011111
101110100010031110130010021011111
101110001111100000001111100000111
101110111111121101100010031110001
101100111111100300404040201111101
101101111111111110111111111111101
100000000000000000000000000000001
111111111111111111111111111111111
