111111111111111111111
100000000000000011111
101111111111111011111
101111111111111001111
101111111111111101111
101111111111100000111
101111111111141010111
101111111111102040301
101111111111130111101
101111111111100111151
101111111111141111111
101111111111100111111
101111111111140111111
101111102040304011111
101111100010021011111
101110001111100001111
101110111111111101111
101100111111111100111
101101111111111110111
100000000000000000111
111111111111111111111
