111111111111111111111111111111111
100000000000000000000000000000001
101101111111111011111111111101101
101100102040404003204040302030101
101110130010001101100010041012001
101000001111100000001111100000101
101410121111111111100010001014101
101020301111111111102040453000101
101301111111111111111111111104101
101001111111111111111111111100101
101411111111111111111111111114101
101001111111111111111111111100101
101401111111111111111111111103101
101000304040404040201111103020101
101410120010001010131111121014101
101000001111100000001111100000101
100210131111111101120010031110001
101030201111111100403040201111101
101101111111111110111111111111101
100000000000000000000000000000001
111111111111111111111111111111111
