111111111111111111
111111111111110011
100000000000005001
102111100011112101
110111111111110101
110111110000030331
110000112201113131
111110110001113111
111110112101111111
111110000201111111
111111110001111111
111111111111111111
