1111111111111
1111111100111
1020000004011
1000111101011
1111111101011
1111030002011
1111010121011
1111010002011
1111011101011
1111013001011
1111511011011
1111111011011
1111113030401
1111111000001
1111111111111
