1111111111111111111
1111111111111100111
1000200003000002011
1020001111111101011
1101111111111101011
1001000111020000011
1020020111010101511
1001101111010030411
1111001111011131311
1111020023011331311
1111001100011311011
1111111111111311011
1111111111102020001
1111111111100000001
1111111111111111111
