111111111111111
111100111111111
100000133111111
100100034300011
100100136421001
102120111402201
100100001030001
102120100011111
100000111111111
111100111111111
111111111111111
