11111111111111111
10000000000111111
10200000000111111
11102211110111111
10020001110100001
10201101100000101
10201133300110001
10025131311110101
11100133300010201
11111111011010111
11111111000010111
11111111000000011
11111111100100011
11111111111111111
