11111111111111111
11000111100111111
11520000000111111
11100011110111111
10002001110100001
10201101100000101
10201143300110001
11001131311110101
11111133000010201
11111111311010111
11111111002010111
11111111002000011
11111111100100011
11111111111111111
