11111111111111111
11111110000000001
11100022101111101
11100010001111101
13101012101111131
13402010500000331
13302020201102331
13111110120110131
10111110200110111
10111110000110111
10111111111112111
10000000000000111
11111111111111111
