1111111111
1000000001
1012211101
1030003101
1011122201
1013335101
1000000001
1111111111
