111111111111111
111100010001111
110002010200001
113211010110001
110011313111011
112011313100211
110011303100011
112011101110111
110010201110111
110110001110111
110111101110111
110111000110111
100111212114311
105000000000311
100111111110011
111111111111111
