11111111111111
11000111111001
11010000000001
11020112101001
11010010201011
11022010001011
11510011111011
10200111111011
10110111111011
13003000000211
13111121113331
13300020004431
11111000100111
11111111111111
