1111111111
1000000001
1012211101
1033030101
1011122201
1013305101
1000000001
1111111111
