111111111111111111
111111111111100011
111111343000000001
111113333211111001
111113310002002211
110002110111010011
112000110001002011
110202110102051011
112020010001001011
110200010101211011
112020010100000011
110011010111111211
114331010111033311
103130020000031311
103332020202043311
111111111111110011
111111111111111111
