1111111111111111
1111111111100111
1111000000000111
1111001111010111
1111101111000011
1111131111000011
1111101111101111
1111101111103111
1102001111334111
1100021111333111
1110251111113111
1110001111103201
1110111110202001
1020111110201011
1020000000000011
1000111111111111
1111111111111111
