1111111111111111111
1111111111111110011
1110002002020202011
1110212100000031011
1110000000111102011
1110011210111101011
1110210200111100011
1110010201000101011
1110110110003101511
1110000010213131211
1110111000003340011
1003111111110111011
1011111111102033311
1003111111101111301
1100000000000033301
1100111111111111111
1111111111111111111
