11111111111111111
11001111111111111
11032000002000311
11001303001130111
11101151111102001
10002003200123101
10121000010132101
10101141110100201
10103101100001001
10100000000110201
10300110131102301
11011110113103101
11000000000022201
11001111100110101
11111111111110001
11111111111111111
