1111111111111111111
1100011111111111111
1102011111111100111
1102013331000003331
1001113332020204331
1000004331111003331
1001111111111111011
1101100000020202011
1101101002102020211
1100020010020202011
1101100020102020011
1101112010000500011
1101110011111111111
1003331001111111111
1013430201111111111
1000111111111111111
1111111111111111111
