1111111111
1000000001
1011211101
1033300101
1011122301
1023251101
1000000001
1111111111
