1111111111111111111
1100011111111111111
1102011111111111111
1102013311111130231
1001113303000020001
1020003431111113001
1001111111111111011
1101100030020102011
1101101002102020011
1100020310020402011
1101100013102620011
1101111011100000011
1101111011111111111
1003331001111111111
1010200201111111111
1000111111111111111
1111111111111111111
