1111111111111111111
1111111364001111111
1100000343103330201
1001101101111010001
1000001101110011101
1100001100012000201
1100201111000010011
1120000001110112011
1100002201110110011
1100100011110110111
1100111111110110111
1100010003333110111
1101010011111310111
1102000211111410111
1102110011111020111
1100111111111000111
1111111111111111111
