111111111111111
111111130030311
110000000010001
100110110111101
100024100001101
112000100001601
110040011020201
110002011111011
110002111111011
110000111111011
112011111111011
110001000000031
111101011113301
111302011111111
111111111111111
