1111111111
1000000001
1011211101
1013330101
1020122301
1004051101
1000000001
1111111111
