1111111111111111
1111111111110011
1033000000003311
1033100202013311
1101122122210211
1120100000010011
1100111011112211
1120133430000011
1100033631111211
1120113331020011
1100001111020211
1102023331020201
1101113432000201
1100000111000001
1111111111111111
