111111111111111
111111111111001
100000000000301
100010310111001
110112212111041
112010000111001
110011101111241
111013020000001
111000050111111
111111333111111
111111111111111
