111111111111111
111111111111001
100300000000401
100110220021301
110111010201011
110011000011011
110011101111011
110211333250001
110032331111101
110011111100001
110001111101111
112100300101111
110111020001111
110000011111111
111111111111111
