111111111111111
131111111111311
131111111111311
101111111110211
101111111110011
101111111110211
101111111110011
105231111111011
100111111000011
100001111020211
102004331022001
101113330020201
100000111000001
111111111111111
