1111111111111111111
1111111000011110011
1004004310203002011
1010000011200304011
1004101211001111011
1110000011001000011
1110001411060011211
1112001011043100011
1113010404310121311
1112000100010100011
1110001110100131211
1000100000003011001
1014402040404000001
1000111111111111111
1111111111111111111
