1111111111111111111
1111111000011110011
1003000310230043211
1012000011000000011
1000101411301111411
1112000011001000011
1110001211405001411
1114011011002120011
1110010304010031411
1114000100010120011
1110001111100331211
1020100000000011001
1013404040404000001
1000111111111111111
1111111111111111111
