1111111111111111111
1111111000011110011
1004004010405200011
1010000011020303011
1003101411001111011
1112000011021000011
1113001411030011211
1112001011043100011
1113010204410121311
1112000100010100011
1110001110100131211
1000100000003011001
1014402011113000001
1000111111111111111
1111111111111111111
