111111111111111
111100001111001
110221000400001
110031100320401
110101100111101
100001103100001
101121102001111
101101104311111
101040441000111
100010001610111
110111010210111
110000010300111
111303020201111
111111111111111
