1111111111111111
1111111000011111
1004006211001111
1010000011101111
1000101311101111
1112300011101111
1110311011000111
1112011011010111
1110010020310001
1113200110312101
1110001110110101
1000102003004001
1014200320100011
1000111111111111
1111111111111111
