11111111111111
11111110000111
10020343110011
10100333111011
10001012111011
11102000111011
11102210111001
11100010111101
11100103061101
11120001111101
11100011131001
10001000020011
10121111001111
10001111111111
11111111111111
