11111111111111111
11330000000111111
11310300110111111
11010101110003111
11300201111101111
11001001111123111
11101111113100001
11101111114112101
10321111110500101
10020111110111101
11010111112111001
11000000300020011
11211010111111111
11002020111111111
11000111111111111
11111111111111111
