111111111111111111
111111111111111001
111135200000000001
111113001000111001
111111011000000001
110000011011201111
110010011330001111
111011111111101111
111011113111101111
100011110100001111
100001112101111111
110101110101111111
110100000002003111
110110101111111111
110200201111111111
110011111111111111
111111111111111111
