111111111111111111
113020111111110001
110210111111300101
112015111111101001
110011311111101031
112013020000041001
110301011111031201
110100010001011001
110001000100011401
112204011111011021
113010030000011301
110011111110001011
110011111111000011
100020111111101111
100000000000001111
111111111111111111
