11111111111
10000000001
13333333001
11111111001
10000202201
10000000001
11121111001
15000002001
11111120201
11111100001
11111111111
