1111111111111111111
1100111111111111111
1140023232323200001
1100100000000001001
1140101111111111011
1100100111111111011
1120103000000311211
1103010111110111011
1121500111110111011
1100210111110110011
1133030111110110111
1120130000000110111
1100111111103110111
1120111111110000111
1020111111111111111
1000111111111111111
1111111111111111111
