1111111111111111111
1110302323232300001
1110100000000301001
1110101111111001011
1110133111111011311
1110132000000410011
1132015111110312011
1111000111110102011
1100010000000100011
1122020111110100411
1100120000000100011
1100131111102013211
1100111111113000011
1003202011111011111
1000000000000011111
1111111111111111111
