1111111111111111111
1000000111111111111
1011110111111111111
1011110020200204001
1001110000203005101
1101110131012100101
1101110110030030101
1101000003101110101
1101013100041110101
1100011110001113101
1111111111011112201
1111111111000100101
1111111111012101101
1111111111000101101
1111111111100003001
1111111111111111111
