11111111111
10303030301
10030303001
11111112001
10000202001
10000000001
11121111001
15000201001
11102020001
11111000001
11111111111
