1111111111111111111
1000000111111111111
1011110111111111111
1011110000250000001
1001110011010000101
1101110111010110101
1101110110000110101
1101000300101110101
1101011130301110101
1100011111411110101
1111111111011110001
1111111100400110101
1111111101210110101
1111110200003110101
1111110002100302001
1111111100111110011
1111111111111111111
