111111111111111111
111111111111113111
111111111111110111
111111111111110111
111111111111110111
111111111111110111
111111111111110111
111111111111110111
111111111111110111
111111111000110111
111111111010100001
102000005200100101
100020031100003001
111111111111110011
111111111111111111
