111111111111111111
113000000000002001
111111200000036101
111111311111100101
111111111111120101
111111111111100101
111111111111110101
111111111111110101
111111111111110001
111111100000110101
102000021010110101
100000000003100101
111111111100004001
111111111111110011
111111111111111111
