111111111111111111
111111111001330001
111111111032000101
111311111001303001
100011111101101011
101000300021003011
101011411001020011
132011000001111011
101011011021111211
101210251101000011
101000221003012311
101110101033010011
101002001111110311
100020000000002011
111111111111100111
111111111111111111
