1111111111111111111
1111111111001110001
1110000111023333101
1100220111001104001
1100011111101101011
1101000200001102011
1101011211001100011
1121011000001111011
1101011011101001011
1101011001131300011
1101000001161310211
1101111101111310011
1001111101111110211
1000000000000000011
1111111111111100111
1111111111111111111
