11111111111111111
13020113000200001
11110000011011101
11111111111000101
11111003000010001
11110310111000111
11110020331012111
11110010133000111
11111610202020001
11111112111110101
11111110030010401
11111110101000201
11111110201111001
11111111001111111
11111111111111111
