1111111111111111111
1111111334000011111
1111111115111000111
1111111110111010111
1111111113111010111
1111111110000000001
1111113110111110101
1111110110320013201
1110002000101000011
1000200020001111111
1021111111001111111
1001111111111111111
1111111111111111111
