1111111111111111111
1111000111111110001
1111013304030004001
1000010000000100111
1011110111111110111
1011115111000110111
1011002000310000111
1011011111010110111
1000011110030110111
1022111110001110111
1010111112111110111
1000111110111110111
1110111110111110111
1102111113111110111
1100000000000000201
1111111111111110001
1111111111111111111
