1111111111111111111
1111000111111110001
1111013000020002301
1000010300000002111
1010010111111100111
1000110111000120111
1001000005410000111
1000011111011110111
1023111113011110111
1121111113031000111
1131111110111010111
1111111112111013111
1111111110003020111
1111111112111110111
1111111110000000201
1111111111111110001
1111111111111111111
