11111111111
10030303001
10303030301
11111110001
10000202001
10000000101
11121111001
15020001201
11102002001
11111000001
11111111111
