1111111111111111111
1111110011111111111
1110000002531111111
1110111011101111111
1110311011132000111
1111311011100110111
1111030401110000001
1111011101110011201
1000011001111111001
1041011011111111011
1100000011111111011
1101110001000000011
1101111101011111111
1100000002011111111
1100201111111111111
1111001111111111111
1111111111111111111
