1111111111111111111
1110011111000111111
1110000000020111111
1110111011101111111
1113111011120000111
1111111011133110111
1111613201113000001
1111011101110311001
1000011001111211011
1021011011111000011
1100000011111111011
1111111000000000011
1111111111111220011
1111111111111000011
1111111111111111111
