1111111111111111111
1111111110001111111
1000000000101003301
1001111102100001301
1101000100011111011
1101033010011111001
1101101000011132201
1101130111011111001
1101120004331111001
1101100002101111001
1101111100201111001
1101111110001111001
1100000001111111001
1101111101025200001
1102000000000001001
1100111111111111111
1111111111111111111
