11111111111
13000003031
10303030001
10111011101
10002000201
10000000001
11101111201
15000202001
11100001121
11110000001
11111111111
