111111111111111111
111111111000111111
102000000310110001
105111110010000101
110111111311111101
110110001001111101
110112100001100001
110110011101101111
110113000300101111
110111110110101111
110111110230001111
110002011000111111
110000201111111111
111100001111111111
111111111111111111
