111111111111111111
133110011111110011
133000200000033011
133111000111113011
100110012100012111
100110210005010011
100110000112110011
100111113110010011
100100203300011211
100133403111102001
100113111102020201
100110001100202001
110110333102020201
110111444020202001
113000033102020201
111111111100000001
111111111111111111
