111111111111111111
100111111111111111
100000200000000111
103111000111110111
130110012111112111
110110110005110011
110110000111113011
110111111111111011
110111111111111211
110111111111102001
110111111111040401
110111311100231301
110111000101111401
110111422023132301
110000003101111101
111111111100000001
111111111111111111
