111111111111111111
130111111111111111
100000000000000111
102111000111110111
110111110111110111
113111110111110011
100111110111111011
103111110111111011
100100200111111011
100100100111111501
103110111111111101
100110401100011101
110110000101011101
110111200002211101
110000001101311101
111111111100000001
111111111111111111
