111111111111111
111332000000111
111005111110111
110013100010111
110210030010011
110000112111011
111110110111011
100003000111011
130403111100001
110111102000101
110301100233201
110001102001201
111000000020201
111001101110101
111111100000001
111111111111111
