1111111
1133311
1030301
1003001
1100011
1110111
1100011
1002001
1002001
1022201
1002001
1105011
1111111
