111111111111111
110010000011111
104040423011111
140404232303111
100000050020111
131313121313111
102020200020111
111111101111111
111020002000111
111313101314111
102000000000001
100010010010001
111111111111111
