111111111111111
111110000010011
111110440240401
111111103202041
111111100030001
111111151010131
111111120040201
111111101111111
102040203020201
131010101013131
103000000300001
100011111110001
111111111111111
