11111111111
11001000001
10402013401
14040200041
10000300001
13131015131
10202022111
11111110111
11111000111
11111013111
11111000111
11111111111
