1111111111111111111
1111111111111001111
1000001110000000011
1000001110001003011
1100000000001003011
1101111110011100011
1101111111111111011
1100001111111100011
1100001111111122011
1111011111111133111
1111011111111111111
1111011111111111111
1111011111111111111
1111002500300000001
1111011111111212101
1111000000000000001
1111111111111111111
