1111111111111111111
1111111111111331111
1300001000000000511
1303401043001023011
1100200000001023011
1100001113311000011
1101111111111111011
1100031333331000031
1100031022201022231
1103011204321234041
1101011022203022231
1100011333331333331
1111011111111111111
1020000000000000201
1022022222222222201
1000000000000000001
1111111111111111111
