1111111
1133311
1003001
1003001
1103011
1110111
1100011
1002001
1020201
1002001
1020201
1105011
1111111
