11111111111111111
10000000000000111
10111111111110111
10111111111110111
10113111111110111
10104000001110111
10104011104010111
10104000004010111
10104444442010111
10100000000012111
10111111111010301
10002520002020401
11134343434344201
11100000000000001
11111111111111111
