1111111111111111111
1110000000000000111
1130111111111110111
1040111111111110111
1540111111111110111
1040111111111110111
1040111111111110111
1040111111111110111
1040111111111110111
1040111111111113111
1040111111111110201
1040000000000000401
1044444444444244401
1000000000000000001
1111111111111111111
