1111111111111
1111111130001
1111111113101
1110203002301
1110040450111
1112321210111
1113030303111
1110121242111
1110230300111
1000004020111
1010112112111
1020300230311
1111111111111
