1111111111111
1111300230051
1111110113101
1110203200401
1110040420131
1112321230121
1113030303001
1110121242101
1110230300131
1000004020111
1010112112111
1020300230311
1111111111111
