1111111111111111111
1000000001000000051
1024441101011121111
1110000101023101111
1110000401023131111
1111111340231111111
1111111301031111111
1110000401040000111
1110000401040000111
1024411101011144201
1000000001000000001
1111111111111111111
