1111111111111111111
1000000001000000051
1024441101011111111
1110000101011111111
1110000401023111111
1111111323201111111
1111111301301111111
1110030201023111111
1110000401023111111
1024411101111111111
1000000001111111111
1111111111111111111
