1111111111111111111
1100000001000001111
1523111101011121111
1111111101023101111
1111111101001131111
1111111332031111111
1111111401231111111
1110000401032000111
1110000401032000111
1024411101011144201
1000000001000000001
1111111111111111111
