1111111111111111111
1000000001000000001
1004411101011142201
1110011101040003111
1110020301002300111
1111111640331111111
1111111401231111111
1110000401032000111
1110000401032000111
1024411101011144201
1000000001000000001
1111111111111111111
