111111111111
111000001111
111010101311
111210302211
111012121011
111330303011
113442424231
113330203031
111030203011
110011101011
112211102211
102311121011
100000500011
111111111111
