111111111111111111
100111111111000111
130000020102010111
133301020102010111
110601020102010201
110301020102010201
110301020102010201
100001020002000001
103031100011111111
103031111111111111
103333111111111111
111111111111111111
