1111111111111
1103000000111
1101041010051
1001020011141
1011121110001
1000100042401
1010131010101
1342203010001
1000121411101
1011100201001
1000131401031
1130000004011
1111111111111
