1111111111111111111
1001111000000000111
1000000020202020111
1000011111120202001
1111011105102020101
1111013131110202001
1111010131111023111
1111013131111131111
1111010131111111111
1111010131111111111
1111310131111111111
1111010101111111111
1111010131111111111
1110010001111111111
1110000001111111111
1111110001111111111
1111111111111111111
