111111111
100303201
101010101
101010101
101020101
132210201
101020131
101010101
101010101
100303501
111111111
