111111111111111111111
100000000000000000301
100111111101111112101
112100000201102000101
100102111101100113101
101000025101110113101
101010101001110013101
100200201033310013101
111000111303312023101
111112001000310013101
111110201011102000201
111110001000001000001
111111111111111111111
