1111111111111111111111111111111
1150001111111111111111111111111
1333000001111111111111111111111
1111101101111111111111111111111
1111100000011100100011100000111
1111100110010000000020002010001
1111110110000000110111111110101
1111100100111100110000000020001
1111100003011100000112101111111
1111101101011111110110001111111
1300000001011111110000201111111
1111111100011111111100111111111
1111111111111111111111111111111
