1111111111
1000111111
1023202011
1110101011
1110100011
1110111011
1100333351
1102020001
1101110111
1100000111
1111111111
