111111111
100511111
103220001
111010121
111010001
111011101
110011331
110000001
110111011
110000011
111111111
