111111111
111111331
100003001
102105331
100112111
102000001
100101001
102102011
100110011
111111111
