11111111111111111
11111111111000111
11111111110002011
11111111110250301
11111111111121001
10000000000001311
10111111111111311
10000000000000311
11012101210121311
11000000000000311
11111111111111111
