11111111111
11111000111
11023012111
11000300001
11016110001
11011110011
10011110211
10111110011
10111111011
10000000011
11111111111
