111111111111111
111000111111111
110020001001111
110210200301111
110311121401111
111010000311111
131310121301111
100020301100011
101151100111211
101101100000001
100001101000001
111101101111111
111100000111111
111100110111111
111100000111111
111111111111111
