1111111
1100011
1330331
1300031
1100011
1110111
1100011
1000001
1020201
1025201
1020201
1100011
1111111
