111111111111111
111110000000111
100000011112111
101122003333111
101001213110301
101010013111201
101010110111001
100010052000011
100000010011111
110200011111111
111110011111111
111111111111111
