11111111111111111111111111111
11111111111111100111111111111
11111111111100200011111111111
11111111100203113011111111111
11004023203111110011111111111
11013300011111112011111111111
10002201111111113111111111001
10011011111111111100000000001
10100201111111111100110110001
10100201111111103000000110011
10101001111100000001100110011
10100011111101000111111110011
10101115111101100100000000311
10000000000000001101111111111
11111111111111101101111111111
11111111111111100001111111111
11111111111111111111111111111
