11111111111111111111111111111
11111111100011111111111111111
11130232032011111111111111111
11020000020111111111111111111
10000001111111111111111111001
10011011111111111100000000001
10100001111111111100110110001
10100001111111100000000111301
10101011111100000001100111301
10100011111101000111111110001
10151111111101100100000000111
10020003000000000101111111111
11111111111111101101111111111
11111111111111100001111111111
11111111111111111111111111111
