1111111
1100011
1300031
1330331
1100011
1110111
1100011
1002001
1022201
1025201
1000001
1100011
1111111
