11111111111
11100011111
11132001111
10323203111
10232320011
10023532001
11002323201
11130232311
11111023111
11111001111
11111111111
