111111111111111
111000111111111
111010100011111
111030001011111
111101003011111
130220111210001
111100300230101
111104220010001
111102543100111
111132220130011
113200303131011
111211102200011
111000110111111
111310030011111
111111101011111
111111100011111
111111111111111
