111111111111
100011111111
103231111111
102323111111
103232311111
102323211111
103232511111
102323231111
100232320231
104323232011
100232323231
100000000011
111111111111
