11111111111111111111111
11000000001111111000111
10020201001111111510111
10211111000011111110001
10011033100011111111101
11230303001011111111101
10002000011001111111101
10211110310001111111101
10000111000301111111001
12110001111001111111011
10020301111211111111011
13210131111011111111011
10010001111000111111011
13201101100010011111011
11101000101111000000011
11100010001111111111111
11111111111111111111111
