1111111111111111
1111110001111111
1111110131111311
1111110300000331
1111111131111011
1111111101000011
1111111101011211
1001111101001011
1020111102000311
1002011101001111
1100201101101111
1110021101001111
1111000052011111
1111111100111111
1111111111111111
