1111111111111111111
1111111111100000001
1111110011102303301
1111110011110111301
1113002020000111101
1110021211110133301
1110102011110133001
1002020011100200001
1013110201101111001
1001113101100000011
1100230100001111111
1110020111141111111
1111142511001111111
1111100000011111111
1111111111111111111
