11111111111111
11110000011111
11000110030111
11011001010151
11002200020001
11101001011111
11120201311111
10301001311111
10020113301111
11040000001111
11111111111111
