1111111111111111111111111
1111111111111110000002311
1111111111111110031102001
1111111111111111011110301
1111111111111111013202111
1111000001111111010013111
1100011002010002300240011
1101100131010101010011011
1100000030000100011100011
1110100161111111000001111
1110000111111111111111111
1020100111111111111111111
1000111111111111111111111
1102111111111111111111111
1100111111111111111111111
1111111111111111111111111
