11111111111111111111111
11110001111111111111111
11100200020011100111111
11104131311011120000011
11104001004000400111001
11101111000010000111101
11050011111111101111001
11030002000000001111011
11011311111011111000011
11011111111011111340011
11011111111000000024011
10011111111111111110011
10111100001111111110111
10011101100011111110111
11000001111011111110111
11111111111000000100111
11111111111111110001111
11111111111111111111111
