11111111111111111
10033111111001001
10033111111021001
11013002011002001
11002220001011211
11313012020010011
11313110111020011
11310002001010011
11301100051011211
11300011110000011
11300000020021011
11301111111100011
11111111111111111
