11111111111111111
10033111111001001
10033111111021301
11013002011032001
11002220001011211
11013012020010011
11013110111010311
11010002001010011
11001100051011211
11003111110000011
11000000020321311
11001111111100011
11111111111111111
