1111111111111111
1000100011111001
1040000001132401
1121113100511001
1030102111011311
1020030001201001
1110110100302001
1100100111011001
1101101110010011
1100040010110111
1111001004000111
1111101110011111
1111100010111111
1111111000111111
1111111111111111
