1111111111111111111
1111000111000000011
1111010111011111011
1000005111011001011
1010132010011000231
1010130010011021111
1010011110111101111
1010000000301020311
1010111111001000111
1010111110011110111
1010111110000000201
1010111110011110001
1000111111111111111
1111111111111111111
