11111111111111111111111
11111110001110000000111
11110010101110111110111
11110000001110110010001
11110101131100110000201
11110101111100110011011
11110100111101111011201
11110130000002010000001
11110101111115010001111
11110101111100111101111
11110101111100000000011
11110101111100111100011
13000001111111111111111
11111111111111111111111
