11111111111111111111111
11111111111110001111111
11111110000000131110001
11000000101110160000301
10011111101100120111211
10111111101100000110011
10111111101111110100111
10111111101100000101111
10111111121101110001111
10000000000001111011111
11111111111111000300111
11111100011111022122111
11111102311111333033311
11111111011111022122011
11111111000000000300011
11111111111111111111111
