111111111111111
111111111100011
100000000202011
102112110151011
100020110121011
110110110300011
110003333111011
110111313111011
110111333300011
110200311011211
110121011000201
110101011011201
110200000000001
110001111111111
111111111111111
