1111111111111111111
1111111110010011111
1111100010000000011
1111101000110110011
1100000010100110111
1001110210002000201
1300000010110010001
1300100005010111011
1300100111000000001
1111111101100010001
1111111111111111111
