111111111111111111111111111
111111111111111111111110001
111111111000102000202022101
111111111010000010000010001
111111111011111113111310211
111111000011111110030010011
111111010000011130010030011
111111013111311111113111011
110000010000011110010030011
112010000010011110040010011
113010111011111113111112011
102010000010000011111115001
101020111000102000000000101
100011111111111111111110001
111111111111111111111111111
