11111111111111111111111111
10001111111111111111111111
10102020200020000000000011
10201000001000111111111001
11001311131111111111111101
11201003001111111111111101
11003001003111111111111101
11011131111111111111111101
11030001111111111111111001
11501111111111111111111011
11201111111111111111111011
10001111111111111111111011
10100000000000000000000011
10001111111111111111111111
11111111111111111111111111
