111111111111111111
111111111100111111
110000000000011111
100011011000110331
101220202212110331
101000500010000331
100210111220000331
100000000201100331
111000000001111111
111001111111111111
111111111111111111
