1111111111111111111
1111111330000100011
1111113300000000011
1111133001010100111
1111300010101000011
1111000100100001011
1001101000000000011
1052020111001000111
1020002000101000111
1112200010101010111
1110002000101011111
1110010111110000001
1110000100010000101
1110011100011000001
1110010000001000011
1111110000001111111
