11111111111111111111111111
11111001100000000000110011
11111020302011111110002011
11103000111111111111110031
11101111111111111111111111
11101111111111111111111111
11101111111111111111111111
11001111111111311111111111
11001111111111311111111111
10403000111111311111110031
10001020302011011020302011
11111000102005200020110011
11111111100010001000111111
11111111111111111111111111
