111111111111111111111111111
100011111111111111111110001
101500002000202300201000101
100210000010000010000010201
110011111311111111111110311
110010030011111111110010011
110000010011111111110000011
110111311111113111110111211
110030011111113000010000011
110011111111110010000012011
110011111111111110111110111
100010000010000010000010111
101000111000111000111000111
100011111111111111111111111
111111111111111111111111111
