111111111111111111111111111111
111111111111111110001111111111
111111102040403232320111111111
111100001000000000100000011111
100131131311310113101131311111
102100320200210004020021003201
100300120020200012002023001001
102113131131311010113101131201
110300203001000500000100003011
110300001003000000100002003011
102131131311010110101131311201
100100320200210002020021003001
102300120020200012002023001201
111113131101011013113131131001
111110000001000000000100001111
111111111020202004040201111111
111111111100011111111111111111
111111111111111111111111111111
