1111111111
1000000001
1022211001
1033250001
1003222001
1013333101
1000000001
1111111111
