111111111111111111111111111
111100001000000111111111111
111101101011310111111131111
111100320200210011110021111
111110121320230011112320001
111110131131311011113101101
110000100001004500111100001
110100001002000230100302001
102101101311010110101131011
103100320203210032020021001
102300123020200012032023001
111110131131011313113131101
111030300301000003030100001
111020202023232302020202011
111111111100011111111111111
111111111111111111111111111
