11111111111
11111113111
10230003201
10232020401
10404012101
10303230001
11201115111
10304030111
10104040111
10232320111
10230020111
11031111111
11111111111
