111111111
111111131
111000001
111011101
111011121
111011101
111011151
100020301
101010101
101023101
102300201
110311111
111111111
