11111111111
11131116011
11102002401
11101110101
11101110101
11101110001
11101110111
10003200111
10101310111
10102010111
10232020111
11030113111
11111111111
