1111111111
1130320201
1530023401
1101110101
1101110001
1101110111
1101110001
1103040101
1110223201
1110003201
1111111111
