1111111111
1000000001
1022211101
1033250101
1013222001
1013333101
1000000001
1111111111
