11111111111111111111
10000111111110010001
10112111111110222201
10030111111110363301
11003110000011343311
11121110111011220201
11100000111000000001
11111111111111111111
