111111111111111111
100001111111111111
102201111111111111
103461111111111111
113311111111111111
102020111111111111
100000111111111111
101111111111111111
101100000011111111
101332011011111111
101002102031102031
100010000000001111
111111111111111111
