111111111111111111
111111111111110011
111111111111130011
111111111111042201
111111111111001301
111111111111022201
111000000001030301
133201101100130311
111210051110012111
111000111111000111
111111111111111111
