111111111111
111130002011
111112130011
110030120011
112000300011
130040001201
111100023001
110002400111
150140002011
112300130011
130011111111
111111111111
