1111111111
1111110001
1102000001
1100200001
1000020001
1050200001
1020202001
1003130021
1343334331
1003130011
1020202011
1300200311
1111111111
