1111111111111111111
1111100011111111111
1111100011111111111
1111100011111111111
1110000001111111111
1110101101000111111
1000101101111100001
1020020000000000031
1111121110151100331
1111100000111111111
1111111111111111111
