1111111111111111111
1111111111110000331
1111111111110000331
1000010000000000331
1000010222210000331
1002200000010000331
1000010222211111111
1000010000011111111
1151111111111111111
1111111111111111111
