1111111111111
1111100115111
1111100020111
1111100120111
1111100020011
1113100110211
1333102200001
1333002000001
1333001002211
1101021000011
1101000011111
1101011111111
1100011111111
1111111111111
