1111111111111111
1111001111111111
1111002000111111
1133320200110001
1133311120020001
1133332000202011
1110110000111211
1000110300020001
1011110101100201
1000000001101051
1111110111001111
1111110000011111
1111111111111111
