11111111111111111111111
11111111111110001111111
11111110000000300000001
11111110110113131101101
11111110000000000000001
11111111110121212101111
11111100000000000001111
10000000300000111111111
10110113100000000001111
10000000000000102101111
11110120202000100001111
11110000000110131111111
11151111000000311111111
11100000000001111111111
11110121212101111111111
10000000000000001111111
10110113131001101111111
10000000300000001111111
11111100000111111111111
11111111111111111111111
