11111111111111111111
11111111110011111111
11111111112011111111
11111110000000011111
11111110113111011111
11111110111111011111
11111110062011010001
11111111111013020001
11100011311011011111
11101000000011011111
10200010211111011111
10111310010002311111
10001111110000111111
10002300000111111111
11111111111111111111
