111111111111
131001000111
131021210111
131000010201
131121010101
100000000101
150101110001
100000000111
131121210111
131001010111
131021002011
131000010011
111111110011
111111111111
