11111111111111111
11311111113111111
13000000000311111
11011000110111111
11011100010111111
11011121000111311
11000452000000031
11000121100011011
11110001110001011
11311001110100011
11002000200200011
11011000010110011
11013000000111111
11020030020111311
11011000200020011
11000000111011011
11111101300031011
11111102000002011
11111101101011011
11111100000000011
11111111111111111
