11111111111111111
11111111131111111
10023032003200111
10100010120010001
10000000452030001
10101010121010111
10023032003200111
11111111131111111
11111111111111111
