1111111111111111111
1111110011111111111
1111100001111111111
1111100001001111111
1113131010300011111
1110111010000011111
1000111013100130001
1000002020000111001
1100100011120111011
1111100000252000011
1111110011121110011
1111111111101111011
1111110031101111011
1111110000000000011
1111111001111111111
1111111111111111111
