11111111111111111
11111100000000011
10020001020002011
10211001014001211
10000020003000011
10011001113010001
10031053431333001
11111101113011001
11111120003011001
11111101014011201
11111102020011001
11111100000111111
11111111111111111
