11111111111111
10000000000011
10222220300031
10002000303031
11102000030301
11105111111111
11111111111111
