11111
10001
13251
10201
13231
10201
13231
11111
