1111111
1311131
1002001
1025201
1002001
1300031
1111111
