111111111
111311131
131011101
100025201
102002001
100110111
111113111
111111111
