111111111
131000131
101010101
100020001
100252001
100020001
101111101
131111131
111111111
