111111111111
111111131111
111111101111
100111101131
100252000101
101121000001
101100202001
131100000001
111101111101
111131111131
111111111111
