11111111
11300031
11322231
11125211
13022231
11000031
13222311
13000311
11111111
