1111111111111
1111100011111
1000022011111
1011101000001
1011131111101
1011333011101
1003342020101
1110002000001
1003130010111
1011330020111
1023330020111
1100052000111
1103110010111
1101112020111
1101110001111
1102002201111
1111110001111
1111111111111
