11111111
11131311
11320231
13222011
10252031
13212111
11313111
11111111
