1111111
1302031
1302001
1002001
1002031
1112211
1152031
1332031
1111111
