11111111111
11131000031
11101001111
11103222311
13100251111
10100222311
10002030111
10000000031
11122231111
11100011111
13000003111
11111111111
