11111111111111111111
11111110010011111111
11111110200201111111
11111100200101111111
11111100000101111111
11111113330100000001
10200233033500000201
10000003330330111111
11110100000000001111
11110200201200201111
11111110200201111111
11111110000111111111
11111111111111111111
