111111111
113030311
131002131
102222001
130254001
100222201
131200131
113030311
111111111
