111111111
131131131
100030001
120222001
130252031
100222121
100003001
131131131
111111111
