11111111111
10000000001
10111311101
10031413001
10043631011
11011411011
11011011011
11020002011
11020020011
11000002211
11111100011
11111111111
