111111111111111111111
100011000011001111111
102000002000001111111
102020202023421111111
111111133000003000001
111113343113023112101
102033334330303310001
101111333312003312201
100001333000003100201
102021402021211101211
100000000000000002511
112022012022011111111
110001110001111111111
111111111111111111111
