11111111
11100111
10200001
10020001
10022211
10303201
11036331
11111111
