11111111111
10331133301
10310000001
10422011011
10010502001
10100110101
10200020201
10001000111
11111111111
