1111111111111
1033113333111
1030000000331
1040000000011
1000222000011
1010010502001
1020000020101
1100200020201
1110011000111
1111111111111
