11111111111
11003433301
10002000001
10020202001
10202020001
10020002001
10002003311
11200043331
10005043331
10000434301
10220020011
10000000111
11111111111
