11111111111
11111000011
10200221011
10121000311
10002013401
10010234301
10222133301
11000031351
11111111111
