111111111111
111100000001
111021020101
100201210201
100100002001
100001200001
102105001401
110000210301
100101033311
102020133301
100010333301
111111111111
