1111111111111111111
1111100011111111111
1111100011111111111
1111102011111111111
1110002001111111111
1110101101000111111
1000101101111100031
1020020000000000331
1111121110151100331
1111100000111111111
1111111111111111111
