11111111111111111111
11000001111111111111
11010002011111111111
11010000000000000001
11033311111111000001
11010020200001111011
11010010111100010211
11011010000012010201
11011012015010010001
11011010010110010111
11011010002020010011
11011020000000330011
10011111111111111111
10000303033311111111
11111111111111111111
