111111111111
111020003331
111012103331
100020100131
102200110031
100110110011
100020030031
100002003031
100020000031
102200110031
100110110011
101020510011
100202011011
112010000011
110011110011
111111111111
