1111111111111111111
1110011111111111111
1112010001111111111
1102000200201110011
1023001410001102011
1000111611100001011
1101033333310202011
1101044444330102001
1100143134110202001
1002103133111101001
1000001110011100111
1110200022000000111
1111111110011111111
1111111111111111111
