1111111111111111
1110011111111111
1114010001111111
1104000230111111
1040001410001111
1000111611100001
1101000000010101
1101042422000101
1101143132110231
1001103130111101
1030301110011101
1110200022000001
1111111110011111
1111111111111111
