1111111111111111111
1111110001111111111
1111100320111110011
1110001110001102011
1100111111100001011
1101000033310202011
1101023433330102001
1101121113110522001
1001101113111101001
1020201110111100111
1110000000000000111
1111111110011111111
1111111111111111111
