111111111111111
111110001111111
111100100111111
110001110001111
100111511100001
101000000010101
101022424000101
101113134111101
101113130111101
100001110011101
111100024000001
111111110011111
111111111111111
