11111111111111
11100111111111
11140100011111
11040002001111
10400112100011
10011110111001
11011300000101
11011001020301
11011211111111
10011011111111
10303011111111
11102035111111
11111111111111
