1111111111111111111
1110011111111111111
1112010001111111111
1102000000201110011
1020001310001102011
1000111311100501011
1101043333310202011
1101033433340102001
1100131114110202001
1002101113111101001
1020231110011100111
1110002002000000111
1111111110011111111
1111111111111111111
