1111111111111111111111
1111100111111111111111
1111102111111111111111
1111020233311111111111
1110020000111111111111
1110111110111111111111
1000111110001111111111
1011111102000111111111
1000100020200310000011
1020100020000002001011
1000000111100000000011
1110000111101001331011
1111110111101100330011
1111100200000500331031
1111020111121000002001
1111000000101101111001
1111000000101101111331
1111111100101101111331
1111111120200000201331
1111111100111100001111
1111111111111111111111
