11111111111111111
11100111111111111
11140100011111111
11530202301111111
11400114100011111
11011113111000011
11010000000101011
11010304040001011
11011411121102011
10011011101111011
10303011100111001
11102000020000001
11111111100111111
11111111111111111
