11111111111111111
11111111111110011
11111111111102011
11111111111001011
11000003310202011
11023433330102001
11121113110001001
11101110111101001
10201110111100111
10000002000000111
11111115011111111
11111111111111111
