11111111111111111
11111111111001111
11110010202201111
11020220001001111
11030023110011001
11110010010002201
11110130011001001
11110135330100011
11330202012302001
10330111103011101
10440300032302001
10011111111111111
11111111111111111
