111111111
111001111
102044011
100002011
111001001
111013301
111310501
100020401
100011111
111111111
