1111111111111111
1111100111111111
1111000200100011
1110002030030011
1110102041212111
1020111100333011
1010111112110011
1013111000100111
1034010404001001
1120312323135001
1001303230124401
1001311100103011
1022020111103011
1100010000142211
1110000110000011
1111111111111111
