1111111111111111
1111000100111111
1111003023111111
1111121110111111
1111000100011111
1111232233211001
1000033103002001
1210020102001301
1011011111011011
1010200100201201
1310034143000301
1111230500411111
1111000100011111
1111101111111111
1111102003111111
1111111111111111
