1111111111
1000100111
1023003111
1121110111
1000150011
1010034011
1011124001
1011100001
1011111211
1011111001
1011113001
1010002311
1000100011
1111111111
