11111111111111
11000100111111
11023000111111
11121110111111
11000100011111
11010002311001
11011134302201
11011102001301
11011111011011
10020100001001
10043144000301
11040001011111
11005100011111
11111111111111
