11111111111111111111
11000000000111111111
11011111110000111111
10210010011110000011
10000220310010444001
10010010210200203101
11001001310100120001
10021043330110203111
10020013330510201111
11022213300010111111
11103311111110011111
11111000000004011111
11111111111110011111
11111111111111111111
