111111111111111
100010001111111
104000200200111
111012110110111
111210433110011
111000033112011
110012311110011
110210431110111
110003611110111
111011011110111
110000000000401
110211111110001
110011111111111
111111111111111
