111111111111111
111111111110011
100010001022011
102000000300011
112010111110111
110013111110111
111003311110111
110013111110111
110013111110111
110061111110011
111011111110211
110000000000201
110020111110001
110011111111111
111111111111111
