111111111111111
100010001111111
102000200200111
112012110110111
110210433110011
111003333112011
110014311110011
110216433110111
110033311110011
111011011110211
110000002000201
110220100010001
110011111111111
111111111111111
