111111111111111
111111111110011
100010001022011
100000200400011
112012110110111
110013433110011
111503331112011
110213411110011
110013311110111
110043311110011
111011011110211
110000000000201
110220111110001
110011111111111
111111111111111
