11111111111111111111111
11111100111111111111111
11111102111111111111111
11111100100001111111111
11111132121101111111111
11111130003300020000001
11111132121121000121201
11111100103301202020011
10000001123321000200011
10111111103301111112111
10002020223122020200001
10133343332334333343101
10133343103331334343101
10102020204422020020101
10111111101301111111101
10100000121321100000001
10152020103301001111111
10111120123321231111111
10020200031100031111111
10200002100001231111111
11111100111111001111111
11111111111111201111111
11111111111111001111111
11111111111111111111111
