11111111111111111111111
11111111100001111111111
11111111121101111111111
11111110003300002000001
11111110121121202101201
11111100103301000002011
10000001124321020200011
10111111103301111110111
10000000003100002000201
10111113330333111111101
10111113133331111111101
10111111103301111111101
10111111101101111111101
10100000101101100000001
10102020101101001111111
10111120101101011111111
10020005021100231111111
10000202100001111111111
11111100111111111111111
11111111111111111111111
