11111111111111111111111
11111100111111111111111
11111102111111111111111
11111100111111111111111
11111132111111111111111
11111130000000023001111
11111132111111303121111
11111100111111202023011
10000001113111030400011
10111111100001111112111
10002020220122023200301
10133340002002333343101
10133340100001334343101
10102020202222020020101
10111111101301111111101
10100000121321100000001
10151110103301001111111
10111110123321231111111
10110200031100301111111
10200311100001231111111
11111111111111001111111
11111111111111201111111
11111111111111001111111
11111111111111111111111
