1111111111111111111
1000000100000000001
1020200000202020201
1112110213120112111
1110010013100100111
1111001113111001111
1111100113110011111
1111113304043111111
1111113406043111111
1111100113110011111
1111001113111001111
1110010013100100111
1112100013120110111
1020200003300200201
1000000100010000001
1111111111111111111
