1111111111111111111
1000000100000000001
1040400000404040401
1112111110111112111
1110011110111100111
1111001110111001111
1111100110110011111
1111113302043111111
1111110200043111111
1111100113110011111
1111001113111001111
1115010013100100111
1112110213120110111
1000040000300200201
1000000100010000001
1111111111111111111
