111111111111111111
100100111111111001
102400111111111001
100140100111111301
110150000111311011
110111120111020011
110111101111010011
113111101111211111
110020101003011111
110103403321011111
110100002001011111
132011000111011111
130401111111000111
100020000000200111
100011111101131111
111111111100001111
111111111111111111
