111111111111111111
111111111100111001
111111111104200001
111111111102001401
111111111100011011
111111111100000011
111111111102011111
111111111111011111
110001111152011111
110101111101011111
110100000001011111
110111111110040111
110111111112000111
133400000033030111
100311111101121111
111111111100001111
111111111111111111
