111111111111111111
100100111100111001
100000111102020001
100120111102002001
110100031100011011
110111101100020011
110111101102010011
110111101111211111
110001101102011111
110101101101011111
110100000001011111
113111111110040111
114311111112330111
164300000033340111
100311111101121111
111111111100001111
111111111111111111
