1111111111
1510011111
1202011111
1010010011
1010000011
1012010011
1010010111
1011110111
1000110111
1010110111
1010300031
1311100011
1111111111
