111111111111111111111111
111100000111111111111111
110000000111111111111111
110012110000001111111111
111010000000001111001111
111010100000000000000001
111010100021101101211001
100213100000000000011011
102013100000220111011011
100213110131020501011011
102013334333020001001011
100211020131000002001011
100000002000000010001011
111111020133333330011211
111111002101111111110011
111111000000000000000111
111111111111111111111111
