1111111111111111
1111111311100011
1110000203002011
1110102531112111
1000111100030011
1011111112110011
1011111000100111
1030010400001111
1121012300400201
1001003031111101
1031011111111001
1021011111111011
1100010000111011
1111000110000011
1111111111111111
