111111111111111111111111111111
111103040010001111111111111111
111002002300001111111111111111
111010203111211111111111111111
102011110003001111111111111111
101011111211001111111111111111
101311100010011111111111111111
100001040000111111111111111111
111101230032000111111111111111
111100303011040111111111111111
113101111111100000111111111111
112101111111101110111111111111
110001000011121100111111111111
111100011000001101111111111111
111111111111111100013000020111
111111111111111115200011110111
111111111111111002111111130011
111111111111111013111111112011
111111111111111013111111100111
111111111111111030011111101001
111111111111111121011111100001
111111111111111001011111111401
111111111111111031011111111011
111111111111111021011111111011
111111111111111100010000111011
111111111111111110000110000011
111111111111111111111111111111
