11111111
11110001
11110201
11003111
11030011
11122011
11130111
10023001
10205001
10304001
11002001
11320211
11032301
10023201
10032001
10303011
11000111
11111111
