1111111
1105001
1004001
1004001
1023211
1002301
1023201
1032001
1303011
1111111
