11111111
11110001
11110201
11003111
11030011
11122011
11130111
10023001
10200001
10304001
11002001
11302011
11042311
11501111
11231111
11311111
11111111
