1111111
1110001
1110201
1103111
1540111
1120111
1130111
1103001
1100001
1123201
1100001
1111111
