111111111111
111111000011
100001020011
103201120011
102200330011
100131131111
111131131001
110033332201
110221102001
111520100001
111000111111
111111111111
