11111111111111111
11111111100000511
11111111102100111
11111111100000111
11111111110020111
11111111100010111
13000001100020001
11300000000000001
13000001111111111
11111111111111111
