1111111111111
1111111000011
1100001020011
1100001120011
1102230030011
1100131131111
1111131131111
1111033330201
1000250000001
1022022011111
1000000111111
1111111111111
