111111111111
111100001111
100001043111
103101040011
104200000011
100131101111
111131101001
115200004201
110021104301
111020100001
111000111111
111111111111
