11111111111111111111
11311111300001111111
11001311111201111111
11333300000001111111
11311300000000000001
11333301111111121131
11311311111110020201
11111111000010000201
10000002025010000201
10200002000010000101
11111201010210001101
11001001010010001101
11021021000020001101
11002001111111211101
11000000000000000031
11111111111111111111
