111111111
111111131
111111121
111111151
111111101
111111101
111113301
100000001
102200011
110000111
111111111
