1111111111111
1111111000011
1100001020011
1102201120011
1100030060011
1111131131111
1111131131111
1111033330201
1000000000001
1022222011111
1000000111111
1111111111111
