1111111111111
1111111000011
1100001020011
1100201120011
1102230030011
1100131131111
1111131131111
1111033330201
1000020220001
1022020200111
1020000300111
1111111311111
1111111311111
1111333325011
1111111022011
1111111000011
1111111111111
