1111111111111
1111111000011
1100001020011
1100201120011
1102230030011
1100131131111
1111131131111
1111033330201
1000020020001
1022020000111
1000000450111
1111111311111
1111111310011
1102333322011
1100011020011
1110211000011
1110011111111
1111111111111
