1111111111111
1111111000011
1100001020011
1100201120011
1102230030011
1100131131111
1111131131111
1111033330201
1000020220001
1022020000111
1000005320111
1001311311111
1111311310011
1100334322011
1100211020011
1110201000011
1110001111111
1111111111111
