11111111111111
11000011111111
10202201111111
13303331111111
10220000111111
11102022011111
11133033311111
11102200001111
11111020220111
11111330333111
11111022000011
11111110202201
11111113333331
11111110220201
11111111105111
11111111111111
