11111111111111111111
11130001001111000001
13400001000002000201
10211001000011002201
10000002011011000011
11011000000011111111
10331110111111111111
10333310111111000111
10333310115200020111
11113310110001000111
11111110111111112111
11100002000001100011
11101002002000200011
11100001000001102011
11111111110011100111
11111111111111111111
