11111111111111
11000111000011
11020201201211
10020502002011
10111110133331
10011020131131
11002000033331
11022112133331
11000100012011
11111102000011
11111111100111
11111111111111
