1111111111111111
1105011111110011
1121011110010001
1101010402000001
1101004023011011
1101040404011011
1101001110011011
1101041111111011
1101001111111011
1101040311111011
1101111111111001
1000000000000301
1000111111111001
1111111111111111
