1111111111111111111111
1000111111111111111111
1010111111100111111111
1010111100000111111111
1010045200010111110001
1010223100010404000001
1010011100004040011011
1011111101030404011011
1011111101000110011011
1011111101010111111011
1011111101010111111011
1000000000030111111011
1111111111110111111011
1111111111110000000011
1111111111111111111111
