1111111111111111111111
1000111111111111111111
1010111111100111111111
1010111100002111111111
1010040000015111110001
1010223100010404000001
1010011100003040011011
1011111111030404011011
1011111111000110011011
1011111111010111111011
1011111111010111111011
1000000000010111111011
1111111111110111111011
1111111111110000000011
1111111111111111111111
