1111111111111111
1100011111110011
1101011110010501
1101010430000201
1101004032011011
1101130322011011
1101111110011011
1101111110111011
1101111110111011
1101111110111011
1101111110111001
1020000000000001
1000111110111001
1111111113111111
1111111111111111
