11111111111111111111
10000011111111000001
10200010000000202001
10101012010001020001
10120002022001011101
10101012000001020201
10200010000000000001
11101111111111100001
11000011005111110011
11010011220011111011
11010000202011111011
11010010002013333331
11010110011113333301
11010011111111111301
11000000000003333331
11111111111111111111
