11111111111111
11110011111111
10000201111111
10000000000011
11010443141211
10000334330001
10202334330001
11010443441211
11252000000011
11020200001111
11000020001111
11110001111111
11111111111111
