111111111111111111111111
100010010011111111110011
100200000000200000000011
131013111313201322111311
101310132010201000111001
131113110010201222111301
101310132010221050111001
131213111311131113111311
100200000000000200202011
100111111111111111100011
111111111111111111111111
