1111111111111
1111113111111
1111133311111
1111133511111
1110033300111
1110113110111
1000002000001
1001002001001
1121211121211
1101002001011
1100002000011
1110010100111
1110110110111
1110020200111
1110110110111
1110000000111
1111111111111
