11111111111111
11100100100011
11502102020201
10020000102001
10220133100201
11101333311011
10003311330201
10203311330001
11011333310111
10200133102001
10020100020201
10202020102001
11000100100011
11111111111111
