111111111111111
111001001000111
115021020202011
100200001020011
102211331002011
111013333110111
100000111302011
102000100000011
110020000102011
102000333020011
100201333132011
102023401340011
110003301330011
111011333310111
110203133132001
110020100020201
110202020102001
111000100100011
111111111111111
