111111111111
113311110011
113302000011
110201110011
112120031001
100003100001
100302300001
100230020011
112020002001
102000203401
102001303401
100130021211
110011102011
110000253311
110011113311
111111111111
