1111111111111111111
1100011100011111111
1002211122001111111
1021311131201111111
1023331333201111111
1001320231001111111
1101102011011111111
1101320231001111111
1023331333001100011
1021311332201122001
1002200022001131201
1100001020031333201
1111111001320231001
1111111101102011011
1111111101320231001
1111111023331333201
1111111021311131501
1111111002200022001
1111111100001100011
1111111111111111111
