111111111111111111
133100000000000001
133100102020201101
133101110111001001
133101022111211201
133100000002520201
133002102010220101
100100100111000101
100001110011011101
133100002020000001
133101120011011201
133100100111011001
133100112201211201
133100000000000001
111111111111111111
