1111111111111
1133010000111
1130012120111
1130010020111
1110330220001
1000300020201
1300300020201
1121102100201
1000050000201
1023203120201
1020013000001
1020000000001
1020210013211
1000000033001
1000000300031
1110202100131
1110010100331
1110000133331
1111111111111
