111111111111111111111
111113033311111111111
111023232320033311111
111011131020232320111
110013332310031110111
110023333320032310011
110013333320033320011
111201130000330310011
100200200200201112111
102120200200200000201
100000002220222021251
111111100000002200201
111111111000111000111
111111111111111111111
