111111111111
100000000011
100020020011
111110000001
111110011301
100000001301
102000200301
100011001301
110011001301
102000201301
100001001301
111001111301
111000005001
100200002001
100000100001
111111111111
