111111111111111
111110303011111
111000033311111
111210333402011
110000210000011
100000200000001
101212212210101
100020532300001
101212212210101
100000200000001
110000210000011
111210333412111
111000333300111
111110333111111
111111111111111
