11111111111111111
13333311111111111
13333300020201111
10011110002001001
10015110200201201
10010010020001001
10010210000111201
10010011111111001
10010200000001001
10011010001000001
10000000000001111
10001010101011111
11000000000011111
11111111111111111
