111111111111111
110000010000001
110110300101101
133330033333101
133031013033101
111111011111101
111111000000001
111111021111101
110000151000101
112020121000101
102002020022201
100200121000101
100022101220101
111100000011101
111111111000001
111111111111111
