11111111111111111
11000001000000111
11011000010110111
13333303333310111
13303101303310111
11111101111110111
11111100000000111
11111000010000001
11000010000000101
11200030000030101
10200002001110101
10020012001110101
11002210000000301
11110000021110101
11110000150000101
11112020111000101
11102002020012201
11100200111000101
11110022111211101
11111100000011101
11111111111000001
11111111111111111
