11111111111111111111111111111
11111111111110000000133333331
11111111111110222010231333331
11111111111110010203333331331
11111111111110200101113133331
11111111111110020220100000001
10000000133330030200022001001
10222010231330330010101001101
10010203333330002110101100001
10200101113130002020100001111
10020220100000002000100111111
10010200022001001220100111111
10110010101001200020100111111
10202110101100000000000111111
10252020100001111111111111111
10202000100001111111111111111
11011220100111111111111111111
11220020100111111111111111111
11000000000111111111111111111
11111111111111111111111111111
