11111111111111
11111110001111
13430022002001
13301110110101
13331110010101
11010010010101
11220012010101
10013200010201
10311222000151
10013200010101
11220012010101
11011110010101
11011100110101
13330022002001
13301110001111
13331111111111
11111111111111
