11111111111111111111
13333311111111111111
13333330020201111111
10013330000020201111
11010010200002001001
11010115020200201201
11010110000020001001
11010111210000011201
11010000011111011001
11010111211111011001
11000000011111000001
11111111111111001111
11111111111111111111
