11111111111111111111
11111111100011000011
11111111102010001011
13330333100020002001
13130131111111010101
10333331100002000001
10301101125201112111
11010000001001000001
11000000100001010101
11201012000002002001
10201000100101010101
10102000000001000001
10001002001111111111
11111112101111111111
11111110001111111111
11111111111111111111
