1111111111111111111111111111111111
1111111111111111111111110001113131
1111111111111111111110010101133131
1111111111110000000000012101333031
1111111110010002333000210101133031
1000000000012002333031000001113131
1012012000200100133030000000010031
1002000111000001113002120000000001
1100202010000000010000100111000131
1111110002120000000000101111011101
1100011100100100000100121110011101
1122011100101102001000000102001101
1100011100121100020000100001000021
1102111050000002001001111110000001
1000020000100000001021111110001111
1010011001111110011001111111111111
1000111111111111111111111111111111
1111111111111111111111111111111111
