1111111111111111111111
1111111111111001111111
1111301111111201111111
1113333300011000000001
1133301100011011111201
1111311110111001111001
1111311110000001111101
1110001000000011001101
1000001001210102001001
1000001121010000000011
1001111000000001211111
1011111001111102001111
1000000001111001000201
1101115001111011010001
1102000011111001010111
1111110011020000200111
1111111111000111100111
1111111111111111111111
