111111111111111111111111
111111111111111001111111
111111301111111201111111
111113333300011000000001
111133301100011011111201
111111311110111001111001
111111311110000001111101
111110001000000011001101
111000001001210102001001
111000001121010000000011
111001111000000001211111
111011111001100102011111
111000000001120001000201
111333000001100000000001
113333000001101001020111
111131111011100000200111
111131111000000111100111
111000100000001100110111
100000100121010200100111
100000112101000000001111
100111100000000121111111
101111100111110200111111
100000000111100100020111
110111500111101101000111
110200001111100101011111
111111001102000020011111
111111111100011110011111
111111111111111111111111
