111111111111111111111111111
111111111001111001111100011
111111111201111021111102011
111111000000200000011100111
111111020020111102011120111
111111110110033100011100111
111111110111130220002000111
111100110100121100001000111
111120110002100000201100111
100000020000000100013330111
102002011110200102011001331
111011003300001120011333001
111011113322000200011000001
111000114110011100011131111
111020110000111110011131111
111100012110111333011111111
111101000110011100133111111
111100111112011133300111111
111115111110011100000111111
111111111111111113111111111
111111111111111113111111111
111111111111111111111111111
