11111111111
13323023031
10000111031
10020200001
10111110031
10020000001
11022200031
11520111021
11000020001
13032300031
11111111111
