1111111111111111
1100000110000011
1100020110200011
1002020110202001
1021111111111201
1000000110000001
1020200000020201
1111110110111111
1001110110111001
1000000050000001
1000000110000001
1001111111111001
1000033113300001
1000033113300001
1000033113300001
1111111111111111
