111111111111111
111111110000111
111111110110111
111110010000011
111100213121011
111020005000011
111000410110001
102003332001101
100001410020001
100003330101111
110121312001111
110001110011111
111111111111111
