11111111111111111
11111111100000511
11111111102120111
11111111100020111
11111111110020111
11111111100010111
13330001102020001
11330000002020001
13330001111111111
11111111111111111
