1111111111111111111111111111111
1111100111111111111111111110011
1111020011111111111111110010201
1020002001111111111111100202001
1002000200111110000111002000011
1100200020010000110110020000111
1110020002000100330000200001111
1111002000000003333302000011111
1111100000003333003300010111111
1111111110133533003310110111111
1111111100000333333000000011111
1111100000000333330000002001111
1111002000000331110002000200111
1110020000111111111100200020011
1100200001111111111110020002001
1002000011111111111111002000201
1020011111111111111111100211111
1100111111111111111111110011111
1111111111111111111111111111111
