11111111
13333311
10000011
10212011
10202011
10000011
11000001
10022201
10020201
10020001
10005001
13333401
11020201
11021201
11001001
11333331
11111111
