11111111111111111111
11100011000000000111
11101011011211110111
11101000002000000111
11101211101011210111
11100003333300010111
11111013111312110111
10002003333300000111
10101110101110111151
10100000100200000001
10121010101110110111
10201210000000200111
10101012111011111111
10000000000011111111
11111111111111111111
