1111111111111111111111111111111
1110001100001111111000000000111
1110101101121111111011211110111
1110100000201100000002000000111
1110121110101101211101011210111
1110000333330000003333300010111
1111101311101211013111312110111
1000200033330002003333300000111
1010111010110001110101110111151
1010000010020000000100200000001
1012101010110121010101110110111
1020121000000200210000000200111
1010101211100101012111011111111
1000000000000000000000011111111
1111111111111111111111111111111
