11111111111111111
11111111311111111
11111333033311111
11111313031311111
11111013131011111
11111010101011111
11111010101011111
11100010101000111
11101000100010111
10202020202020201
10021212121212001
11000000500000011
11111111111111111
