1111111111111111111
1111111111111000001
1111111133300011101
1113331130000000001
1113000030000000111
1113000000012110001
1111100201000010201
1000100002020020201
1020202202020010001
1020100001000011111
1000112100101003111
1110010000000003111
1000000000011333111
1015100000011111111
1000001111111111111
1111111111111111111
