111111111
100000011
102222211
100020011
100111011
100333011
110111001
110333001
110111111
100333011
100111011
110333001
110111001
100020011
102222211
100050011
111111111
