11111111111
10000001111
10222221111
10002001111
10011101111
10033301111
11011100111
11033300111
11011111111
10033311111
10011111111
11030300011
11002222211
10000020011
10200221011
11000003011
11110111001
11110333001
11110111111
11100333011
11100111011
11110333001
11110111001
11100020011
11102222211
11100050011
11111111111
