111111111111111111111
111111111111111110001
111111111111111110101
111110000000000000101
111000111101001333001
111012100201001113101
111010002000000011101
111000202121001000001
111000105100011111111
130010121120011111111
133000000200111111111
133310200001111111111
111110101111111111111
111110001111111111111
111111111111111111111
