11111111111111111111111
11111111111111000000001
11111111111100011110101
11111111111101210020101
11111111111101000000001
11111111111100020010111
11111000000000000010111
11100011113000030300111
11101210023300000020111
11101000203330000000111
11100020212100100011111
11100010510001111111111
13001012112001111111111
13300000020011111111111
13331020000111111111111
11111010111111111111111
11111000111111111111111
11111111111111111111111
