1111111111
1030303031
1020202201
1110111031
1103001201
1102001031
1111001201
1110311031
1110200201
1111111051
1111111111
