111111111111111
111100010001111
100003303300001
102313222313201
110012010210011
112313010313211
110012010210011
112313010313211
110012010210011
112313010313211
110012010210011
112032060230211
110011111110011
111110000011111
