111111111
111000111
113030311
113434311
113131311
111101111
102020201
102020201
102020201
100050001
111111111
