111111111
110000111
113040311
113434311
113434311
111131111
102020201
102020201
102020201
100050001
111111111
