111111111111111
111100000001111
111102020201111
111141011111111
100100030004001
102100313031201
100104010430001
102134111431201
100034010401001
102130313001201
100400030001001
111111115141111
111102020201111
111100000001111
111111111111111
