1111111111111
1111000001111
1111023201111
1111113111111
1001003001001
1021010101201
1003204033001
1021010101201
1004006001001
1111113111111
1111023201111
1111000001111
1111111111111
