11111111111
11000100011
10400100401
10040104001
10201310201
10143434101
10204340201
10010101001
10410501401
11000100011
11111111111
