1111111111111111111
1111111100001111111
1000001001101111111
1022122213431313131
1000000003004000401
1111111111041212151
1000000003004000401
1022122213431313131
1000001001101111111
1111111100001111111
1111111111111111111
