111111111111
100000040001
102121212001
103333333311
102121212001
100000040001
115111111111
100000040001
102121212001
103333333311
102121212001
100000040001
111111111111
