1111111111111111111
1000000006000000001
1011212121212121101
1002020201020202001
1020434343434340201
1002343434343432001
1020434343434340201
1002343434343432001
1020434343434340201
1002343434343432001
1020434341434340201
1002020201020202001
1010202021202020101
1000000001000000001
1111111111111111111
