111111111111111
100110000011001
100200101002001
102423101321201
110233101332011
100333242333001
101112101211101
100004050400001
101112101211101
100333242333001
110233101332011
102123101321201
100200101002001
100110000011001
111111111111111
