111111111111111111
110004001100400011
100001001100100001
101441433334144101
100001005000100001
102444442444444201
100001002000100001
102211133331112201
100010111111010001
111110000000011111
