111111111111111111
110004000000400011
100201001100100001
102241431334142201
100001002000100001
102444444444444201
100001002000100001
134211133331112131
153310111111013341
131211133331112431
100001002000100001
102444444444444201
100001002000100001
102241431334142201
100201001100100001
110004000000400011
111111111111111111
