11111111111
11110501111
11110101111
11113231111
11130203111
11122122111
11130203111
10003230001
10001110001
11111011111
