111111111111111111
111111001610001111
110000043310100011
100101043340101001
102222201102222201
100101043340101001
110001013340000011
111100013100111111
111111111111111111
