111111111111111111
100000043310000001
101010043340010101
102222231132222201
101010043340010101
100000014340000001
111111116311111111
100000043410000001
101010043340010101
102222231132222201
101010043340010101
100000013340000001
111111111111111111
