11111111111111111
11111110011111111
11111100200111111
11111101210111111
11111100200111111
11100033433000001
11101031313010101
10222243134222201
10101031313010111
10000033434000111
11111100200111111
11111101210111111
11111100200111111
11111111210111111
11111111500111111
11111111111111111
