111110000011111
100011111110001
101000040002101
102443101000001
110313101212011
110333101000011
110111121111011
114000040000411
110111121111011
110000101334011
110212101313011
100000101444201
101200040000101
100011111110051
111110000011111
