111111111111
111100111111
105000200011
101000101211
102310201001
141410001001
103301200201
103330011111
111111111111
