11111111111
11110011111
10020000011
10102012001
10231025101
13331102201
10430120011
10333001111
11111111111
