111111111111111
111003434300111
110010343010011
110211313112011
110201323102011
100102010201001
102200212002201
100102010201001
110201323102011
110211313112011
110010343010011
111003363300111
111111111111111
