1111111000001111111
1000001000001000001
1043001100011003401
1001400110110041001
1021040011100401201
1001104000004011001
1001110400040111001
1001011042401101001
1001001106011001001
1111000111110001111
