1111101111111111
1100111000000111
1100100011110011
1100101100011011
1100122000201011
1100100201001011
1100100201001011
1000100201201011
1001002021001011
1000201001111001
1022211411111101
1133333333333361
1100111111111111
1111111111111111
