11111111111111
10001033310001
10002000020001
11111121111111
10002033320001
10001000010001
11111141111111
11110500001111
11110244201111
11110000001111
11111114111111
10001000010001
10002333020001
11111112111111
10002000020001
10001333010001
11111111111111
