1111111111111111111
1000333334333330001
1010111110111110101
1020000010100000201
1104044010104404011
1111140010100111111
1004044010104404001
1000000010100000001
1021111112111111201
1002020206020202001
1100000001000000011
1111111111111111111
