11111111111
10000000001
10211211201
10200000201
10133333101
14114441161
10133333101
10200400201
10212121201
10000000001
11111111111
