111111111111
100000001111
101111101111
101000101111
101010101111
101000400601
101144041101
102000100101
111110100101
111110100101
111110111101
111110000001
111111111111
