11111111111
10000011111
16444000011
10001410011
11100044201
11111000001
11111111111
