111111111111
100000000001
101411112101
104020030451
110030012101
111110010001
111130011111
111111111111
