11111110001111111
10000010001000001
10212310001321201
10233011111033201
11101023632010111
11103320202330111
11132120102123111
11110000100001111
11111111111111111
