11111111111
10230403201
10003400001
11110001111
10000420001
10230406201
11111111111
