11111111011111111
11110001110001111
11112100100421111
11110010104001111
11040600400304011
10030111010403001
10100111011100101
10042400000424001
11000111111100011
11111100000111111
