11111111111111111
10333333333111111
10420111023111111
13311000133333301
11000020130111301
11021110011001311
11001022220201011
11121000000001011
11001021001111011
11021001201002211
11001021001000011
11021001200101111
11001111000101111
11022020140001111
11000000051001111
11111111111111111
