11111111111
11000000011
11011111001
11040001101
11021003401
11040000401
11111111451
10400000401
10210003401
10400001101
10111111001
10000000011
11111111111
