111111111111
111111110511
111110000111
111102201111
111101011001
111101040001
111102031301
110000301011
102202231211
101001003011
101030001111
104030301111
101301011111
102201211111
101003011111
101131111111
100001111111
111111111111
