111111111111
150011111111
101203001111
100000001111
110203203001
111000003101
111110213201
111111000111
111111111111
