1111111
1111311
1113301
1020001
1021301
1005311
1020011
1022011
1110011
1111111
