111111111
111111311
162000201
100111001
104000401
140111041
104000401
100111001
102000231
113111111
111111111
