111111111111111
111111311111111
111111001111111
115102222011111
110003200011111
110020201111111
111101101111111
111102001111111
100102201001111
102200202201111
100000000001111
111110012001111
111110000222011
111330000200011
111330000201111
111333303101111
111111102001111
111100102201001
111102200202201
111100000000001
111111110011111
111111100011111
111111333333111
111111333333111
111111333333111
111111111111111
