11111111111111111
11100000000011111
11102022022011111
11111100200010001
10000112020010201
10202010202110201
10002000002000001
10111211002111111
10000000000111111
11111111011111111
13333331251111111
13333301001111111
13333000001111111
13333001111111111
11111111111111111
