111111111111111
163333333333201
133333333330201
112111111111001
100100020200201
100000002002001
111110111111001
111110000020001
111111022012001
111111220010201
111111022410201
111111000010201
111111100210211
111111100000011
111111111111111
