11111111111111111
11111100000111111
11111102220203331
11111100011103311
11111102011103331
11111110111103311
11000020020003331
11002020021003311
10021111201503331
10002000201111111
11112000000001111
11110211112001111
11110011110201111
11110011110001111
11111111111111111
