1111111111111111111
1111111111001111111
1000010000000000011
1020000202121220011
1021111110020011011
1001000311000020001
1021013330101000201
1001013330100101111
1021003333110200111
1001113333100120111
1121000131102020111
1020000130000001111
1511000031111111111
1111111111111111111
