1111111111111111
1115111111311111
1110011113311111
1110201133311111
1110022043311111
1111002043111131
1111101001111331
1111101020113331
1111101002204331
1111101000204311
1111101002003111
1000022002001111
1002000020001111
1111110000101111
1111111110100201
1111110002203201
1111110200002001
1111111111000111
1111111111111111
