111111111
104061111
100404001
104010101
100404001
114020111
110000111
111111111
