1111111111111111
1001000011111111
1002002001111111
1001020201111111
1121110111111111
1000020000111111
1000100200111111
1111102020111111
1000102011111111
1022111051110011
1002033331110201
1002133330000201
1000133331110001
1000133331111111
1111111111111111
