1111111111111111
1111111111115001
1000133333320001
1000233333310201
1022133333310111
1000111111110111
1112200020000111
1020200001021111
1020111121100111
1010100000100111
1010102200100111
1000111011121111
1020200000101111
1000010000001111
1111111111111111
