1111111111111111111
1510001000000011111
1000301201111020201
1130101020002010001
1130000301111010101
1133101111110000201
1133020000000012101
1133101110101000201
1133001112121112101
1133111100200002001
1101111000111000111
1100000011111111111
1111111111111111111
