11111111111111111
11100011100000111
11102000004220111
11102111111011111
11102033331020111
11101330202000111
11101341111020111
11101333331020001
11101132231010201
11150130231010101
10002032131022001
10200133431020111
11020111111010111
11110000000000111
11111111111111111
