111111111111111
111000001111111
111021200000001
100202001101201
102202020202301
100000200020211
111110111111011
111110202001011
111110000001001
111330333331001
111333333331001
111331111111211
111332000050201
111111111110201
111111111110001
111111111111111
