1111111111111
1111100000001
1000002120201
1020020202001
1102020000201
1112011011111
1002015033331
1020113333301
1001133333101
1100330311101
1111112111001
1111110010011
1110040200111
1110100221111
1110000001111
1111111111111
