111111111111111
111111005011111
100040022001111
102001101022001
111021331000201
111001331111001
111201333331201
111001333332001
111100431110001
111101331000011
111021111220011
111002020202011
111000000001111
111111111111111
