111111111111111111
111111111000000111
111111111020020111
111111111011121111
100010013331100011
100200013331100201
100210013333102201
111000113333100001
111222013331121111
111000201301020011
111110001121002011
111110230001001011
111111110200011011
111111110211000011
111111110051111111
111111111111111111
