1111111111111111111
1333331000000000011
1131332000111111011
1333331000100001011
1333001000202201011
1302001000100200001
1101000000100111001
1100001000111111011
1101111110011000011
1101000010002021211
1102020010011000011
1101022000011111211
1101000010011000011
1101111110002021211
1100000000011000051
1111111111111111111
