1111111111111111111
1333300000000000001
1300000232000000001
1301111111111112001
1301100000011110011
1331100000000012011
1331002222220010011
1331002500000012001
1331002222220000001
1331000000020012011
1301002222220010011
1301110000000012011
1301111111111110011
1300000233000000011
1333300000000000011
1111111111111111111
