1111111111111111111
1001000100100111111
1021202120100000001
1001000100101110101
1102020202101020101
1000000000101000101
1020202020201011101
1111111110200000001
1100000020111111111
1133333020000000001
1031313010101111101
1033133010100202001
1131313010100020001
1133333010111151111
1111001110000001111
1111111111111111111
