1111111111111
1100005000011
1301040401031
1240104010421
1004042404001
1100401040011
1110040400111
1111003001111
1111101011111
1111100011111
1111101011111
1111100011111
1111111111111
