111111111111111
100000111000001
102010020010201
100100050001001
102122131221201
110000131000011
110011131110011
110033333330011
110011131110011
110000131000011
110000131000011
110001131000011
110001131000011
102201101102201
100100202001001
100000111000001
111111111111111
