11111111111
11100010001
10002002001
10121220211
10102002011
10100020011
10110212011
10110020001
10111111001
10110000501
10113333331
10003333331
11111111111
