1111111111111
1111006001111
1110040400111
1100401040011
1004042404001
1240101010421
1304040404031
1100004000011
1110011100111
1100004000011
1304040404031
1240101010421
1004042404001
1100401040011
1110040400111
1111003001111
1111111111111
