11111111111111111
11000000000000011
11011111111111011
11010000000001011
11010202020201011
10012120002121001
13300000500000331
13311111111111331
11111111111111111
