111111111111111111
111000111110000001
111010001100111101
111002220000000001
111011011010100001
110211011200000101
110200500201110101
100211011200010101
101011011011000001
100002220011110101
111111001001110101
111111100000010001
111111111110000001
111111111110001001
111111111110100001
111111111110000101
111111111113333331
111111111113333331
111111111111111111
