11111111111111
11111100011001
11111100020001
11111112111201
11111110330311
10001100100111
10002000000001
11211120110001
11033031111111
10010011111111
10000000111111
15011000111111
11111111111111
