1111111111111
1111100011111
1111006001111
1110040400111
1100101010011
1001140404001
1040102010401
1004040411001
1100101010011
1110040400111
1111001001111
1111100011111
1111111111111
