1111111111111111
1500000000000001
1021111111114101
1000000000000101
1111111111110101
1000000000010101
1011111141010101
1040000001010101
1010111101010101
1010130004010101
1010130000010101
1010111111110101
1010000000000401
1014111111111201
1000000000000001
1111111111111111
