11111111111111111111111111111111
15111111100111100000000001001111
10111102000100001010001101002001
10111000000100000010101101000001
10002000000200020010000002000001
11102111111101111112111111211101
10002000000220000020000002000001
10201000000100110010000021000001
10001000110100000010020002000001
10111111112111111011111101111311
10111000002002002210000001333331
10111011111100000010011001333331
10111011111111102022000001330331
10111011111111100010000003333331
10000011111111110011111111333331
11111111111111111111111111111111
