1111111111
1500000001
1002020201
1122222221
1000003001
1020202021
1122020201
1020202001
1000020201
1110111101
1300103131
1303430131
1311110131
1333330031
1333333031
1111111111
