1111111
1333031
1110001
1102011
1102011
1102011
1102311
1102011
1105011
1111111
