1111111111
1110050111
1100232001
1002023201
1023204311
1230320011
1323030111
1132311111
1100011111
1111111111
