111111111111111111111111
150000001111130111111111
102043302023102111111111
111033400011000111111111
111133311111202111133331
110001001310002000000041
112220201010201111113001
110002201010101111311041
110110001010101111202031
100111111000101111010011
103111111211120000002111
101113110000100111113111
101022020033111111111111
100200022223333332011111
111022000031111100011111
111113111111111111111111
111111111111111111111111
