11111111111111111
11111000000011111
11111020202011111
11111002022011111
10001020020010001
10220102020102201
10002012021002001
10020002020000201
10202011211022001
10200111011110201
10001111011110001
11111111511111111
11111111011111111
11111111011111111
11111113031111111
13333330303333331
13333333303333331
11111111111111111
