11111111111111111111111111111
11111000010000000111111111111
11000211010112010020111111111
11200011000020012100100011111
10011011010110100000201011111
10011002000110001110000011111
10211011111111111111111211001
13333333333333333333333333331
10111111111111111111111101001
10200000020020000000000001001
11111101111020010112111020001
15011100000001010110001101111
11011001020011000111100000001
11011021111201120111110201201
11020001111000001111111100201
11012101111012001111111121011
11000001111000011111111100011
11111111111111111111111111111
