11111111111111111111
10000001000111111111
10200200010011111111
11110011111000000111
11330010000011110111
11311110011110000111
11333300001002011111
11033310001022210011
11131111111002520001
10000011111020100001
10131020000002111201
10131111111100100401
10130000000001100201
10101111111020101001
10001111111000000011
11111111111111111111
