1111111111111
1100000000011
1002020202011
1011441114111
1033331110011
1110333313011
1111141010001
1102020022201
1100500110001
1111111111111
