1111111111111111
1100000111000011
1100110100221011
1120202020200011
1102020100011011
1100220111111311
1020000111113331
1512201111113331
1002000111113331
1000120111113331
1122100100013331
1100000200003331
1111111111110001
1111111111111111
