1111111111111111111
1001000000100010011
1022022102020212011
1001000020120032011
1022220100200012011
1001000100111110011
1101111111111113011
1101111111111113311
1000011111111334411
1020020111111343451
1010010111111433301
1000110033333334311
1111111111111111111
