111111111111111111
111333334333333111
111333434303333111
111111201120111111
102020001100400001
102000001102000201
102111111111111201
100000510010000001
102022210012220201
111110010010011111
111110020220011111
111110000000011111
111111111111111111
