11111111111111
11111111100311
10000100030011
10200000103011
10220120131111
11011101110031
11000000003331
11020000003301
11022002013111
11101110111111
11000200005111
11000212000111
11110010011111
11111111111111
