111111111111111111
100110001100111111
102100120000110011
100102200100300201
102020122101110101
100120000101342201
100100100001332531
101111111101133331
101110000000133331
100102222000133331
100000000011111111
111111111111111111
