111111111111111
111100110011111
111000000001111
111001111001111
111101111011111
100222001011111
100333501011111
111111111011111
100000110010011
100000110000001
101101111001001
101001001111011
100000001111001
111001000000001
111111001110011
111111111111111
