111111111111111111
100111110000111111
102002010000011111
100200010222011111
102001112002013331
102002000111113331
102001100000003331
111221000110003331
110000010150013331
110111110100013331
100020010011113331
100120022201111111
102200100001111111
100100100111111111
111111111111111111
