11111111111111111111
10003333333111111111
10004333333100000001
10010113333001220001
10020033333100002201
11111200111111111501
10000311000100001211
10002002020101002001
11212112000201020001
10202000011222002201
10000011000001001001
11111111111111111111
