1111111111111111111
1100011111111111111
1100500100001031111
1002112122000001111
1020000000201101111
1111200111101021111
1020002002001001111
1002000111001020001
1002112111111131101
1010100000133333101
1000102020133333101
1112112101133333101
1102002020133333001
1100101010231110111
1110000000000000111
1111111111111111111
