11111111111111111111111111111
11000111111111111111111111111
11005001000000311111111111111
10021121220000000100001031111
10200000002002012122000001111
11112001111020200000201101111
10200020020010000111101021111
10020001110020200002001001111
10021121111111300011001020001
10101000001333332011111131101
10001020201333330000133300101
11121121011333332020133300101
11020020201333330001133330101
11001010102302002020133330001
11100000000000001010231110111
11111111111111100000000000111
11111111111111111111111111111
