11111111111111111111
10000011113331500001
10100000043333100001
10020011111343310001
10112111111133431001
10200020010013331001
10220100010001344001
11100222100022002001
10200100100001021001
10002100100002002001
11110000100001001001
11111111111111111111
