1111111111111111111
1110001111111001111
1100200111110201111
1000220200000000111
1522000202020200111
1101111111111102011
1101333331333102001
1101333333343110101
1101331333303100001
1101333111020102201
1101111001210100001
1002002002000111111
1001202201022111111
1002000001000111111
1111111001111111111
1111111111111111111
