11111111111111111
10010040404001001
10010000300001001
10212013131021201
10010013131001001
10222013131022201
10000013131000001
11111113131111111
10000013131000001
10222013131022201
10010013131001001
10212013131021201
10010013131001001
10212013131021201
10010000600001001
10010040404001001
11111111111111111
