111111111111111111111111111111
111000111111100111111111111111
110020011111120111111111111111
100022020000000011111111111111
152200020202020011111111111111
110111111111110201111111111111
110133333133310200111111001111
110133333334300000111111201111
110133133330000000200000000111
110133311102020220202020200111
110111100121000000111111102011
100200200200001000331333102001
100120220102201333333343110101
100200000100001331333303100001
111111100111101333111020102201
111111111111101111001210100001
111111111111102002002000111111
111111111111101202201022111111
111111111111102000001000111111
111111111111111111001111111111
111111111111111111111111111111
