111111111111111111111
111111100111111111111
111111100111111111111
111111100111111111111
111111020200000001111
111111022001000001111
111111001000000111111
111100000201111000001
102000000101002020201
102000000201002020201
100002000001000002201
111112121011111115121
113304343433333333331
111103333331111111111
111111111111111111111
