11111111111111111111
11000003310001500111
11202013320002220111
11011133110111000001
11001333312100211101
11001344310000020201
11001343310101020201
11201133110201210001
11011033011001001211
10200020000201001011
10001111111001000011
11111111111111111111
