1111111111111111111111111111
1100000331000003310001500111
1120201332202013320002220111
1101110011011133110111000001
1100130031000333312100211101
1100132231000344310000020201
1100132031000343310101020201
1120110011200133000201210001
1101100001000033021001001211
1020002000200020000201001011
1000111110000100011001000011
1111111111111111111111111111
