11111111111111111111111
11111111111150111111111
11111333111120111110011
11111333000000100000001
11111333000111100002001
11111333000000111111011
13331333201102100010011
13300000000000020022001
13330000020002002210001
13300002000200002000211
13331020020000100111011
11111000001200200000011
10000201021022100111111
10021002000020002111111
10201100111011110111111
10001111111000000111111
11111111111111111111111
