1111111111111111111
1111110000005000001
1111110202020222201
1111110111111200001
1111344433000020201
1111313141202202001
1111334334000020201
1131314134002202001
1131333333000000001
1133344343002021111
1130300200000200111
1130400200200000111
1131132000001111111
1000111100111111111
1020020020111111111
1111111000111111111
1111111111111111111
