1111111111111111111111111
1000000000000000111111111
1002020202000000000001111
1020202020000033333101111
1002020202020033333300001
1020202020000033333300001
1002020202020033333300001
1020202020000033333300001
1022020202022033333330001
1101111220205033333330001
1001000000100111100330001
1000002000000000001111011
1021100220000000000000011
1020000200002201111110011
1001110211111001111111111
1111110011111111111111111
1111111111111111111111111
