111111111111111
100100000111111
152200200100111
100111200020111
113331000100111
113431100100111
113001000001111
111022020200001
111020000000201
111033310001001
111134311001001
111133311111011
111110110202001
111110200000001
111110011110011
111111111111111
