1111111111111111111
1051000100000011111
1021012100102020111
1020000002222120111
1020201000000000111
1101111111111111111
1034334343434333301
1033433333333343301
1111111111111111011
1110000000000011001
1110222020221011001
1110000111000000201
1111010111110020201
1110000002002001111
1110000100010001111
1111111111111111111
