111111111111111111111
110000000001000000111
100000000000011110111
100000000130001330111
100111111133002000111
111133333333311101111
100221113333311100111
100200013333310020111
102020011111310000111
102022220001111212111
102000010101020000011
102022220001022000011
100000011000020111111
111000000000200000011
110000000000031111011
110000000013030100011
110011111113330200011
111110333333331110111
110022111333331110011
110020001333331002011
110202001111131000011
110202222000111121211
110200001010102000001
110202222000102200001
110000001100002011111
111111111111120011111
111111111111150111111
111111111111111111111
