1111111111111111
1000000000111111
1011102200001111
1000102002001111
1002111121111111
1020110001333311
1002202000333301
1110110201333301
1110110021110001
1110000001110001
1111151111111111
1111111111111111
