11111111011111111
11110001110001111
11110040104001111
11114110101141111
10040200100204001
10000300500300001
11111111111111111
