111111111111111111
100000001111110001
100202001111112201
102001220000000001
111220011111122001
102000011050100201
102202011020100001
100111111011111111
102133333334320001
100133333333310001
102133333333300001
100001111101101001
111000000000021001
102221021121001111
100000001100011111
111111111111111111
