11111111111111111
10000300400300001
10040200100204001
11111110001111111
11110040401111111
11110001011111111
11111111511111111
11111111010001111
11111110404001111
11111110001141111
10040200100204001
10000300400300001
11111111111111111
