11111111111111111111
11001110000151333331
10020010000001133331
10101011211013333331
10102010002223433331
10100010220001033331
10020020010020033331
10002010002000233331
11002110000222200231
10002020220000101001
10000010000000100001
11012111000222200201
11002011220100111001
11000011000001111111
11111111111111111111
