11111111111111111
11100111111111111
11100111111111111
11100001100000111
11133100002210111
11133301100020111
11133400112102001
11133300105202001
11333400202020001
11033300202220111
10000200000011111
10000200001111111
10011111111111111
11111111111111111
