111111111111111111111111
100000100111111111111111
100220000100001111111111
111100112202001001111111
100000100000221020111111
102013331011000002111111
111014313334300110011111
111013333333033020011111
111053313333333000111111
111001111033033000111111
111100000000000020000001
100200102020220000000201
102210102001000202201111
102020202101111111001111
100000000202011111111111
111111111000011111111111
111111111111111111111111
