11111111111111111
11111111111000001
11111111111000001
11111110000000031
11111110011003331
11111111011003331
11111111011111111
11111102220111111
11111100200011111
11000100200010001
15020000000000201
11111100000011111
11111100000011111
11111111111111111
