11111111111111
10333000001111
10101210122001
16220022033301
10101210122001
10333000001111
11111111111111
