1111111111111
1111000111111
1111010100001
1052223330101
1001010110101
1101000100101
1101111100001
1100000000111
1100111111111
1111111111111
