1111111110111111111
1000000011100000001
1012222333331222101
1010101313131010101
1000002213122000001
1110101313131010101
1112221333332222101
1110101313131010101
1000002215122000001
1010101313131010111
1012222333331222111
1010101313131010111
1000002213122000001
1010101313131010101
1012221333332222101
1000000010400000001
1111111111111111111
