111111111111111
100000000001111
101101111100001
102020202020201
111033333311001
111111111511111
110033333311001
102020202020201
101101111100001
100000000001111
111111111111111
