1111111111111111111
1111111004001111111
1100000020200000011
1001111110141111001
1010000010100000101
1030402040402040301
1311111114111111131
1030400040400040301
1010000010100000101
1001111410111111001
1100000025200000011
1111111004001111111
1111111111111111111
