111111111111
111113311111
100033311111
100034300001
120111111101
130000000201
132111111011
122000000011
101011111011
100220202011
110000050111
111111111111
