1111111111111
1004610010001
1204040012101
1001111010001
1044300040111
1333311040001
1022100040101
1000101010001
1022100011111
1000111111111
1111111111111
