1111111111111111111
1111111110100111111
1111110511100111111
1111000000000111111
1110000201101111111
1100101100000111111
1101000200101111111
1102000100100011111
1111000010000010001
1111011000000000001
1000001110011111111
1000001011111111111
1000001111111111111
1003331111111111111
1111111111111111111
