111111111111
110400004001
110111002001
103301021011
104600002011
113301021011
111111002011
111111100011
111111111111
