11111111111
10040000301
10444400101
13340102201
10445000101
13330102201
11111100101
11111112201
11111110001
11111111111
