111111111111
154040404001
102020202001
104010101001
104010101401
104010101001
104040404001
103030303011
111111111111
