1111111111111111111
1111110150111111111
1343311120001111111
1020000002201000401
1030011110001000101
1111110001311214001
1111110104020000001
1111110040310111111
1111111114100111111
1111111110001111111
1111111111111111111
