1111111110111111111
1100000011100000011
1033102204022013301
1001111001001111001
1022013304033102201
1100000011100000011
1111151110111111111
1100000011100000011
1022013304033102201
1001111001001111001
1033102204022013301
1100000011100000011
1111111110111111111
