1111111111111
1111111110001
1111000010101
1332222014201
1133336333001
1112222014201
1110000010101
1111111110001
1111111111111
