1111111110111111111
1110000010100000111
1102002010102002011
1102111111111112011
1002002331332002001
1020000131310000201
1021141031301111201
1000033342433300001
1111141026431111111
1000033344433300001
1021141031301111201
1020000131310000201
1002002331332002001
1102111111111112011
1102002010102002011
1110000010100000111
1111111110111111111
