11111111111111111
11001111111111111
10002000100001111
10021010111111001
11201010100000001
11000033364444201
11111111100000011
11111111111111111
