1111111111111
1111001001111
1001206021001
1021001001201
1003401043001
1113301033111
1003401043001
1021001001201
1001202021001
1111001001111
1111111111111
