1111111111111
1111001001111
1001201000001
1021001001001
1003401120201
1116333330141
1003401120201
1021001001001
1001201000001
1111001001111
1111111111111
